"filename", "language", "Draw.io", "Markdown", "CSS", "Clojure", "comment", "blank", "total"
"f:\data\learn\javaLearn\note\.history\markdown\郭有根-第十八章作业_20220807011135.md", "Markdown", 0, 530, 0, 0, 0, 109, 639
"f:\data\learn\javaLearn\note\.history\markdown\郭有根-第十八章作业_20220807020804.md", "Markdown", 0, 530, 0, 0, 0, 109, 639
"f:\data\learn\javaLearn\note\.history\markdown\郭有根-第十八章作业_20220807021106.md", "Markdown", 0, 530, 0, 0, 0, 109, 639
"f:\data\learn\javaLearn\note\.history\test_20220807022605.drawio", "Draw.io", 0, 0, 0, 0, 0, 1, 1
"f:\data\learn\javaLearn\note\.history\test_20220807022639.drawio", "Draw.io", 13, 0, 0, 0, 0, 0, 13
"f:\data\learn\javaLearn\note\.history\郭有根-第十一章作业_20220721135542.md", "Markdown", 0, 0, 0, 0, 0, 1, 1
"f:\data\learn\javaLearn\note\.history\郭有根-第十一章作业_20220721135544.md", "Markdown", 0, 6, 0, 0, 0, 1, 7
"f:\data\learn\javaLearn\note\.history\郭有根-第十一章作业_20220721135609.md", "Markdown", 0, 58, 0, 0, 0, 1, 59
"f:\data\learn\javaLearn\note\.history\郭有根-第十一章作业_20220721135746.md", "Markdown", 0, 58, 0, 0, 0, 3, 61
"f:\data\learn\javaLearn\note\.history\郭有根-第十一章作业_20220721140107.md", "Markdown", 0, 58, 0, 0, 0, 6, 64
"f:\data\learn\javaLearn\note\.history\郭有根-第十一章作业_20220721140132.md", "Markdown", 0, 15, 0, 0, 0, 7, 22
"f:\data\learn\javaLearn\note\.history\郭有根-第十一章作业_20220721140233.md", "Markdown", 0, 15, 0, 0, 0, 10, 25
"f:\data\learn\javaLearn\note\.history\郭有根-第十一章作业_20220721140441.md", "Markdown", 0, 40, 0, 0, 0, 12, 52
"f:\data\learn\javaLearn\note\.history\郭有根-第十一章作业_20220721140556.md", "Markdown", 0, 41, 0, 0, 0, 14, 55
"f:\data\learn\javaLearn\note\.history\郭有根-第十一章作业_20220721141002.md", "Markdown", 0, 43, 0, 0, 0, 15, 58
"f:\data\learn\javaLearn\note\.history\郭有根-第十一章作业_20220721141056.md", "Markdown", 0, 43, 0, 0, 0, 15, 58
"f:\data\learn\javaLearn\note\.history\郭有根-第十一章作业_20220721141145.md", "Markdown", 0, 44, 0, 0, 0, 15, 59
"f:\data\learn\javaLearn\note\.history\郭有根-第十一章作业_20220721141153.md", "Markdown", 0, 44, 0, 0, 0, 15, 59
"f:\data\learn\javaLearn\note\.history\郭有根-第十一章作业_20220721141332.md", "Markdown", 0, 44, 0, 0, 0, 15, 59
"f:\data\learn\javaLearn\note\.history\郭有根-第十一章作业_20220721141502.md", "Markdown", 0, 43, 0, 0, 0, 14, 57
"f:\data\learn\javaLearn\note\.history\郭有根-第十一章作业_20220721141749.md", "Markdown", 0, 43, 0, 0, 0, 14, 57
"f:\data\learn\javaLearn\note\.history\郭有根-第十一章作业_20220721141816.md", "Markdown", 0, 44, 0, 0, 0, 15, 59
"f:\data\learn\javaLearn\note\.history\郭有根-第十一章作业_20220721141830.md", "Markdown", 0, 46, 0, 0, 0, 16, 62
"f:\data\learn\javaLearn\note\.history\郭有根-第十一章作业_20220721141855.md", "Markdown", 0, 54, 0, 0, 0, 17, 71
"f:\data\learn\javaLearn\note\.history\郭有根-第十一章作业_20220721141918.md", "Markdown", 0, 55, 0, 0, 0, 18, 73
"f:\data\learn\javaLearn\note\.history\郭有根-第十一章作业_20220721141952.md", "Markdown", 0, 60, 0, 0, 0, 19, 79
"f:\data\learn\javaLearn\note\.history\郭有根-第十一章作业_20220721142021.md", "Markdown", 0, 63, 0, 0, 0, 20, 83
"f:\data\learn\javaLearn\note\.history\郭有根-第十一章作业_20220721142046.md", "Markdown", 0, 68, 0, 0, 0, 20, 88
"f:\data\learn\javaLearn\note\.history\郭有根-第十一章作业_20220721142125.md", "Markdown", 0, 68, 0, 0, 0, 20, 88
"f:\data\learn\javaLearn\note\.history\郭有根-第十一章作业_20220721142130.md", "Markdown", 0, 68, 0, 0, 0, 21, 89
"f:\data\learn\javaLearn\note\.history\郭有根-第十一章作业_20220721145834.md", "Markdown", 0, 68, 0, 0, 0, 21, 89
"f:\data\learn\javaLearn\note\.history\郭有根-第十一章作业_20220721145835.md", "Markdown", 0, 74, 0, 0, 0, 21, 95
"f:\data\learn\javaLearn\note\.history\郭有根-第十一章作业_20220721150010.md", "Markdown", 0, 62, 0, 0, 0, 21, 83
"f:\data\learn\javaLearn\note\.history\郭有根-第十一章作业_20220721150130.md", "Markdown", 0, 68, 0, 0, 0, 21, 89
"f:\data\learn\javaLearn\note\.history\郭有根-第十一章作业_20220721150146.md", "Markdown", 0, 68, 0, 0, 0, 22, 90
"f:\data\learn\javaLearn\note\.history\郭有根-第十一章作业_20220721171637.md", "Markdown", 0, 70, 0, 0, 0, 25, 95
"f:\data\learn\javaLearn\note\.history\郭有根-第十一章作业_20220721171754.md", "Markdown", 0, 70, 0, 0, 0, 23, 93
"f:\data\learn\javaLearn\note\.history\郭有根-第十一章作业_20220722091216.md", "Markdown", 0, 70, 0, 0, 0, 23, 93
"f:\data\learn\javaLearn\note\.history\郭有根-第十一章作业_20220722092550.md", "Markdown", 0, 70, 0, 0, 0, 23, 93
"f:\data\learn\javaLearn\note\.history\郭有根-第十一章作业_20220722101351.md", "Markdown", 0, 70, 0, 0, 0, 23, 93
"f:\data\learn\javaLearn\note\.history\郭有根-第十一章作业_20220722102504.md", "Markdown", 0, 71, 0, 0, 0, 23, 94
"f:\data\learn\javaLearn\note\.history\郭有根-第十一章作业_20220722102525.md", "Markdown", 0, 71, 0, 0, 0, 24, 95
"f:\data\learn\javaLearn\note\.history\郭有根-第十一章作业_20220722102602.md", "Markdown", 0, 83, 0, 0, 0, 25, 108
"f:\data\learn\javaLearn\note\.history\郭有根-第十一章作业_20220722102626.md", "Markdown", 0, 70, 0, 0, 0, 24, 94
"f:\data\learn\javaLearn\note\.history\郭有根-第十一章作业_20220722105119.md", "Markdown", 0, 70, 0, 0, 0, 24, 94
"f:\data\learn\javaLearn\note\.history\郭有根-第十一章作业_20220722115747.md", "Markdown", 0, 70, 0, 0, 0, 24, 94
"f:\data\learn\javaLearn\note\.history\郭有根-第十一章作业_20220722131904.md", "Markdown", 0, 75, 0, 0, 0, 27, 102
"f:\data\learn\javaLearn\note\.history\郭有根-第十一章作业_20220722132932.md", "Markdown", 0, 80, 0, 0, 0, 27, 107
"f:\data\learn\javaLearn\note\.history\郭有根-第十一章作业_20220722133831.md", "Markdown", 0, 81, 0, 0, 0, 27, 108
"f:\data\learn\javaLearn\note\.history\郭有根-第十一章作业_20220722141401.md", "Markdown", 0, 74, 0, 0, 0, 26, 100
"f:\data\learn\javaLearn\note\.history\郭有根-第十一章作业_20220722161754.md", "Markdown", 0, 75, 0, 0, 0, 25, 100
"f:\data\learn\javaLearn\note\.history\郭有根-第十一章作业_20220722162026.md", "Markdown", 0, 77, 0, 0, 0, 26, 103
"f:\data\learn\javaLearn\note\.history\郭有根-第十一章作业_20220722162106.md", "Markdown", 0, 80, 0, 0, 0, 28, 108
"f:\data\learn\javaLearn\note\.history\郭有根-第十一章作业_20220722162309.md", "Markdown", 0, 136, 0, 0, 0, 40, 176
"f:\data\learn\javaLearn\note\.history\郭有根-第十一章作业_20220722162749.md", "Markdown", 0, 200, 0, 0, 0, 44, 244
"f:\data\learn\javaLearn\note\.history\郭有根-第十一章作业_20220722162812.md", "Markdown", 0, 201, 0, 0, 0, 46, 247
"f:\data\learn\javaLearn\note\.history\郭有根-第十一章作业_20220722162853.md", "Markdown", 0, 227, 0, 0, 0, 47, 274
"f:\data\learn\javaLearn\note\.history\郭有根-第十一章作业_20220722162914.md", "Markdown", 0, 227, 0, 0, 0, 49, 276
"f:\data\learn\javaLearn\note\.history\郭有根-第十一章作业_20220722163011.md", "Markdown", 0, 228, 0, 0, 0, 48, 276
"f:\data\learn\javaLearn\note\.history\郭有根-第十一章作业_20220722163139.md", "Markdown", 0, 228, 0, 0, 0, 48, 276
"f:\data\learn\javaLearn\note\.history\郭有根-第十一章作业_20220722163348.md", "Markdown", 0, 228, 0, 0, 0, 48, 276
"f:\data\learn\javaLearn\note\.history\郭有根-第十一章作业_20220722163403.md", "Markdown", 0, 228, 0, 0, 0, 48, 276
"f:\data\learn\javaLearn\note\.history\郭有根-第十一章作业_20220722163443.md", "Markdown", 0, 228, 0, 0, 0, 48, 276
"f:\data\learn\javaLearn\note\.history\郭有根-第十一章作业_20220722163728.md", "Markdown", 0, 228, 0, 0, 0, 48, 276
"f:\data\learn\javaLearn\note\.history\郭有根-第十一章作业_20220722164022.md", "Markdown", 0, 228, 0, 0, 0, 48, 276
"f:\data\learn\javaLearn\note\.history\郭有根-第十一章作业_20220722164049.md", "Markdown", 0, 228, 0, 0, 0, 48, 276
"f:\data\learn\javaLearn\note\.history\郭有根-第十一章作业_20220722164124.md", "Markdown", 0, 228, 0, 0, 0, 48, 276
"f:\data\learn\javaLearn\note\.history\郭有根-第十一章作业_20220722164156.md", "Markdown", 0, 228, 0, 0, 0, 48, 276
"f:\data\learn\javaLearn\note\.history\郭有根-第十一章作业_20220722164217.md", "Markdown", 0, 228, 0, 0, 0, 48, 276
"f:\data\learn\javaLearn\note\.history\郭有根-第十一章作业_20220722164259.md", "Markdown", 0, 228, 0, 0, 0, 48, 276
"f:\data\learn\javaLearn\note\.history\郭有根-第十一章作业_20220722164304.md", "Markdown", 0, 228, 0, 0, 0, 47, 275
"f:\data\learn\javaLearn\note\.history\郭有根-第十一章作业_20220722164438.md", "Markdown", 0, 228, 0, 0, 0, 47, 275
"f:\data\learn\javaLearn\note\.history\郭有根-第十七章作业_20220802130604.md", "Markdown", 0, 0, 0, 0, 0, 1, 1
"f:\data\learn\javaLearn\note\.history\郭有根-第十七章作业_20220802130605.md", "Markdown", 0, 6, 0, 0, 0, 1, 7
"f:\data\learn\javaLearn\note\.history\郭有根-第十七章作业_20220802130657.md", "Markdown", 0, 11, 0, 0, 0, 6, 17
"f:\data\learn\javaLearn\note\.history\郭有根-第十七章作业_20220802130725.md", "Markdown", 0, 13, 0, 0, 0, 5, 18
"f:\data\learn\javaLearn\note\.history\郭有根-第十七章作业_20220802130732.md", "Markdown", 0, 14, 0, 0, 0, 5, 19
"f:\data\learn\javaLearn\note\.history\郭有根-第十七章作业_20220802130803.md", "Markdown", 0, 15, 0, 0, 0, 5, 20
"f:\data\learn\javaLearn\note\.history\郭有根-第十七章作业_20220802131425.md", "Markdown", 0, 15, 0, 0, 0, 5, 20
"f:\data\learn\javaLearn\note\.history\郭有根-第十七章作业_20220802131435.md", "Markdown", 0, 15, 0, 0, 0, 7, 22
"f:\data\learn\javaLearn\note\.history\郭有根-第十七章作业_20220802132736.md", "Markdown", 0, 16, 0, 0, 0, 9, 25
"f:\data\learn\javaLearn\note\.history\郭有根-第十七章作业_20220802132926.md", "Markdown", 0, 19, 0, 0, 0, 11, 30
"f:\data\learn\javaLearn\note\.history\郭有根-第十七章作业_20220802133513.md", "Markdown", 0, 19, 0, 0, 0, 13, 32
"f:\data\learn\javaLearn\note\.history\郭有根-第十七章作业_20220802134105.md", "Markdown", 0, 21, 0, 0, 0, 12, 33
"f:\data\learn\javaLearn\note\.history\郭有根-第十七章作业_20220802134233.md", "Markdown", 0, 21, 0, 0, 0, 12, 33
"f:\data\learn\javaLearn\note\.history\郭有根-第十七章作业_20220802134521.md", "Markdown", 0, 24, 0, 0, 0, 11, 35
"f:\data\learn\javaLearn\note\.history\郭有根-第十七章作业_20220802135353.md", "Markdown", 0, 26, 0, 0, 0, 12, 38
"f:\data\learn\javaLearn\note\.history\郭有根-第十七章作业_20220802135447.md", "Markdown", 0, 26, 0, 0, 0, 13, 39
"f:\data\learn\javaLearn\note\.history\郭有根-第十七章作业_20220802140005.md", "Markdown", 0, 27, 0, 0, 0, 15, 42
"f:\data\learn\javaLearn\note\.history\郭有根-第十七章作业_20220802140114.md", "Markdown", 0, 50, 0, 0, 0, 20, 70
"f:\data\learn\javaLearn\note\.history\郭有根-第十七章作业_20220802140200.md", "Markdown", 0, 52, 0, 0, 0, 23, 75
"f:\data\learn\javaLearn\note\.history\郭有根-第十七章作业_20220802140245.md", "Markdown", 0, 81, 0, 0, 0, 27, 108
"f:\data\learn\javaLearn\note\.history\郭有根-第十七章作业_20220802140319.md", "Markdown", 0, 83, 0, 0, 0, 30, 113
"f:\data\learn\javaLearn\note\.history\郭有根-第十七章作业_20220802140327.md", "Markdown", 0, 83, 0, 0, 0, 30, 113
"f:\data\learn\javaLearn\note\.history\郭有根-第十七章作业_20220802140341.md", "Markdown", 0, 84, 0, 0, 0, 30, 114
"f:\data\learn\javaLearn\note\.history\郭有根-第十七章作业_20220802140442.md", "Markdown", 0, 134, 0, 0, 0, 42, 176
"f:\data\learn\javaLearn\note\.history\郭有根-第十七章作业_20220802140545.md", "Markdown", 0, 137, 0, 0, 0, 46, 183
"f:\data\learn\javaLearn\note\.history\郭有根-第十七章作业_20220802140624.md", "Markdown", 0, 182, 0, 0, 0, 57, 239
"f:\data\learn\javaLearn\note\.history\郭有根-第十七章作业_20220802140914.md", "Markdown", 0, 220, 0, 0, 0, 59, 279
"f:\data\learn\javaLearn\note\.history\郭有根-第十七章作业_20220802141119.md", "Markdown", 0, 309, 0, 0, 0, 71, 380
"f:\data\learn\javaLearn\note\.history\郭有根-第十七章作业_20220802141142.md", "Markdown", 0, 311, 0, 0, 0, 74, 385
"f:\data\learn\javaLearn\note\.history\郭有根-第十七章作业_20220802141218.md", "Markdown", 0, 334, 0, 0, 0, 79, 413
"f:\data\learn\javaLearn\note\.history\郭有根-第十七章作业_20220802141305.md", "Markdown", 0, 335, 0, 0, 0, 78, 413
"f:\data\learn\javaLearn\note\.history\郭有根-第十七章作业_20220802141324.md", "Markdown", 0, 336, 0, 0, 0, 77, 413
"f:\data\learn\javaLearn\note\.history\郭有根-第十七章作业_20220802141339.md", "Markdown", 0, 338, 0, 0, 0, 78, 416
"f:\data\learn\javaLearn\note\.history\郭有根-第十七章作业_20220802141353.md", "Markdown", 0, 338, 0, 0, 0, 79, 417
"f:\data\learn\javaLearn\note\.history\郭有根-第十七章作业_20220802141457.md", "Markdown", 0, 372, 0, 0, 0, 87, 459
"f:\data\learn\javaLearn\note\.history\郭有根-第十七章作业_20220802141540.md", "Markdown", 0, 374, 0, 0, 0, 90, 464
"f:\data\learn\javaLearn\note\.history\郭有根-第十七章作业_20220802141618.md", "Markdown", 0, 391, 0, 0, 0, 91, 482
"f:\data\learn\javaLearn\note\.history\郭有根-第十七章作业_20220802141652.md", "Markdown", 0, 392, 0, 0, 0, 92, 484
"f:\data\learn\javaLearn\note\.history\郭有根-第十七章作业_20220802141657.md", "Markdown", 0, 392, 0, 0, 0, 92, 484
"f:\data\learn\javaLearn\note\.history\郭有根-第十七章作业_20220802141730.md", "Markdown", 0, 393, 0, 0, 0, 94, 487
"f:\data\learn\javaLearn\note\.history\郭有根-第十七章作业_20220802141759.md", "Markdown", 0, 497, 0, 0, 0, 102, 599
"f:\data\learn\javaLearn\note\.history\郭有根-第十七章作业_20220802141932.md", "Markdown", 0, 499, 0, 0, 0, 105, 604
"f:\data\learn\javaLearn\note\.history\郭有根-第十七章作业_20220802142013.md", "Markdown", 0, 525, 0, 0, 0, 111, 636
"f:\data\learn\javaLearn\note\.history\郭有根-第十七章作业_20220802142835.md", "Markdown", 0, 526, 0, 0, 0, 111, 637
"f:\data\learn\javaLearn\note\.history\郭有根-第十七章作业_20220802143131.md", "Markdown", 0, 526, 0, 0, 0, 111, 637
"f:\data\learn\javaLearn\note\.history\郭有根-第十七章作业_20220802143536.md", "Markdown", 0, 526, 0, 0, 0, 111, 637
"f:\data\learn\javaLearn\note\.history\郭有根-第十七章作业_20220802143604.md", "Markdown", 0, 526, 0, 0, 0, 111, 637
"f:\data\learn\javaLearn\note\.history\郭有根-第十三章作业_20220725100125.md", "Markdown", 0, 0, 0, 0, 0, 1, 1
"f:\data\learn\javaLearn\note\.history\郭有根-第十三章作业_20220725100127.md", "Markdown", 0, 6, 0, 0, 0, 1, 7
"f:\data\learn\javaLearn\note\.history\郭有根-第十三章作业_20220725100135.md", "Markdown", 0, 11, 0, 0, 0, 4, 15
"f:\data\learn\javaLearn\note\.history\郭有根-第十三章作业_20220725100215.md", "Markdown", 0, 11, 0, 0, 0, 5, 16
"f:\data\learn\javaLearn\note\.history\郭有根-第十三章作业_20220725100303.md", "Markdown", 0, 12, 0, 0, 0, 6, 18
"f:\data\learn\javaLearn\note\.history\郭有根-第十三章作业_20220725100314.md", "Markdown", 0, 13, 0, 0, 0, 7, 20
"f:\data\learn\javaLearn\note\.history\郭有根-第十三章作业_20220725100324.md", "Markdown", 0, 14, 0, 0, 0, 8, 22
"f:\data\learn\javaLearn\note\.history\郭有根-第十三章作业_20220725100348.md", "Markdown", 0, 15, 0, 0, 0, 9, 24
"f:\data\learn\javaLearn\note\.history\郭有根-第十三章作业_20220725100358.md", "Markdown", 0, 16, 0, 0, 0, 10, 26
"f:\data\learn\javaLearn\note\.history\郭有根-第十三章作业_20220725100422.md", "Markdown", 0, 17, 0, 0, 0, 11, 28
"f:\data\learn\javaLearn\note\.history\郭有根-第十三章作业_20220725100430.md", "Markdown", 0, 18, 0, 0, 0, 11, 29
"f:\data\learn\javaLearn\note\.history\郭有根-第十三章作业_20220725100622.md", "Markdown", 0, 20, 0, 0, 0, 11, 31
"f:\data\learn\javaLearn\note\.history\郭有根-第十三章作业_20220725100641.md", "Markdown", 0, 21, 0, 0, 0, 11, 32
"f:\data\learn\javaLearn\note\.history\郭有根-第十三章作业_20220725100708.md", "Markdown", 0, 25, 0, 0, 0, 12, 37
"f:\data\learn\javaLearn\note\.history\郭有根-第十三章作业_20220725100733.md", "Markdown", 0, 43, 0, 0, 0, 12, 55
"f:\data\learn\javaLearn\note\.history\郭有根-第十三章作业_20220725100750.md", "Markdown", 0, 45, 0, 0, 0, 14, 59
"f:\data\learn\javaLearn\note\.history\郭有根-第十三章作业_20220725100802.md", "Markdown", 0, 46, 0, 0, 0, 15, 61
"f:\data\learn\javaLearn\note\.history\郭有根-第十三章作业_20220725100919.md", "Markdown", 0, 49, 0, 0, 0, 15, 64
"f:\data\learn\javaLearn\note\.history\郭有根-第十三章作业_20220725101152.md", "Markdown", 0, 93, 0, 0, 0, 18, 111
"f:\data\learn\javaLearn\note\.history\郭有根-第十三章作业_20220725101446.md", "Markdown", 0, 95, 0, 0, 0, 18, 113
"f:\data\learn\javaLearn\note\.history\郭有根-第十三章作业_20220725101515.md", "Markdown", 0, 94, 0, 0, 0, 21, 115
"f:\data\learn\javaLearn\note\.history\郭有根-第十三章作业_20220725101609.md", "Markdown", 0, 94, 0, 0, 0, 23, 117
"f:\data\learn\javaLearn\note\.history\郭有根-第十三章作业_20220725101637.md", "Markdown", 0, 104, 0, 0, 0, 22, 126
"f:\data\learn\javaLearn\note\.history\郭有根-第十三章作业_20220725101718.md", "Markdown", 0, 107, 0, 0, 0, 23, 130
"f:\data\learn\javaLearn\note\.history\郭有根-第十三章作业_20220725101846.md", "Markdown", 0, 108, 0, 0, 0, 26, 134
"f:\data\learn\javaLearn\note\.history\郭有根-第十三章作业_20220725172942.md", "Markdown", 0, 108, 0, 0, 0, 26, 134
"f:\data\learn\javaLearn\note\.history\郭有根-第十三章作业_20220726024433.md", "Markdown", 0, 108, 0, 0, 0, 26, 134
"f:\data\learn\javaLearn\note\.history\郭有根-第十三章作业_20220726094140.md", "Markdown", 0, 110, 0, 0, 0, 27, 137
"f:\data\learn\javaLearn\note\.history\郭有根-第十三章作业_20220726094344.md", "Markdown", 0, 110, 0, 0, 0, 27, 137
"f:\data\learn\javaLearn\note\.history\郭有根-第十三章作业_20220726094605.md", "Markdown", 0, 110, 0, 0, 0, 27, 137
"f:\data\learn\javaLearn\note\.history\郭有根-第十三章作业_20220726094641.md", "Markdown", 0, 110, 0, 0, 0, 27, 137
"f:\data\learn\javaLearn\note\.history\郭有根-第十三章作业_20220726094653.md", "Markdown", 0, 110, 0, 0, 0, 27, 137
"f:\data\learn\javaLearn\note\.history\郭有根-第十三章作业_20220726094739.md", "Markdown", 0, 111, 0, 0, 0, 27, 138
"f:\data\learn\javaLearn\note\.history\郭有根-第十三章作业_20220726094825.md", "Markdown", 0, 112, 0, 0, 0, 27, 139
"f:\data\learn\javaLearn\note\.history\郭有根-第十三章作业_20220726095129.md", "Markdown", 0, 113, 0, 0, 0, 28, 141
"f:\data\learn\javaLearn\note\.history\郭有根-第十三章作业_20220726095657.md", "Markdown", 0, 115, 0, 0, 0, 28, 143
"f:\data\learn\javaLearn\note\.history\郭有根-第十三章作业_20220726095826.md", "Markdown", 0, 117, 0, 0, 0, 30, 147
"f:\data\learn\javaLearn\note\.history\郭有根-第十三章作业_20220726100126.md", "Markdown", 0, 120, 0, 0, 0, 33, 153
"f:\data\learn\javaLearn\note\.history\郭有根-第十三章作业_20220726100149.md", "Markdown", 0, 267, 0, 0, 0, 39, 306
"f:\data\learn\javaLearn\note\.history\郭有根-第十三章作业_20220726100331.md", "Markdown", 0, 269, 0, 0, 0, 41, 310
"f:\data\learn\javaLearn\note\.history\郭有根-第十三章作业_20220726100358.md", "Markdown", 0, 291, 0, 0, 0, 45, 336
"f:\data\learn\javaLearn\note\.history\郭有根-第十三章作业_20220726100500.md", "Markdown", 0, 292, 0, 0, 0, 45, 337
"f:\data\learn\javaLearn\note\.history\郭有根-第十三章作业_20220726100548.md", "Markdown", 0, 293, 0, 0, 0, 45, 338
"f:\data\learn\javaLearn\note\.history\郭有根-第十三章作业_20220726100725.md", "Markdown", 0, 294, 0, 0, 0, 43, 337
"f:\data\learn\javaLearn\note\.history\郭有根-第十三章作业_20220726101422.md", "Markdown", 0, 297, 0, 0, 0, 45, 342
"f:\data\learn\javaLearn\note\.history\郭有根-第十三章作业_20220726101517.md", "Markdown", 0, 393, 0, 0, 0, 51, 444
"f:\data\learn\javaLearn\note\.history\郭有根-第十三章作业_20220726101531.md", "Markdown", 0, 410, 0, 0, 0, 52, 462
"f:\data\learn\javaLearn\note\.history\郭有根-第十三章作业_20220726101558.md", "Markdown", 0, 410, 0, 0, 0, 54, 464
"f:\data\learn\javaLearn\note\.history\郭有根-第十三章作业_20220726101722.md", "Markdown", 0, 411, 0, 0, 0, 54, 465
"f:\data\learn\javaLearn\note\.history\郭有根-第十三章作业_20220726101835.md", "Markdown", 0, 413, 0, 0, 0, 53, 466
"f:\data\learn\javaLearn\note\.history\郭有根-第十三章作业_20220726101842.md", "Markdown", 0, 413, 0, 0, 0, 53, 466
"f:\data\learn\javaLearn\note\.history\郭有根-第十三章作业_20220726101857.md", "Markdown", 0, 413, 0, 0, 0, 53, 466
"f:\data\learn\javaLearn\note\.history\郭有根-第十三章作业_20220726102043.md", "Markdown", 0, 413, 0, 0, 0, 53, 466
"f:\data\learn\javaLearn\note\.history\郭有根-第十三章作业_20220726102120.md", "Markdown", 0, 413, 0, 0, 0, 55, 468
"f:\data\learn\javaLearn\note\.history\郭有根-第十三章作业_20220726102203.md", "Markdown", 0, 414, 0, 0, 0, 54, 468
"f:\data\learn\javaLearn\note\.history\郭有根-第十三章作业_20220726102319.md", "Markdown", 0, 415, 0, 0, 0, 54, 469
"f:\data\learn\javaLearn\note\.history\郭有根-第十三章作业_20220726102330.md", "Markdown", 0, 415, 0, 0, 0, 54, 469
"f:\data\learn\javaLearn\note\.history\郭有根-第十三章作业_20220726102444.md", "Markdown", 0, 415, 0, 0, 0, 54, 469
"f:\data\learn\javaLearn\note\.history\郭有根-第十三章作业_20220726102445.md", "Markdown", 0, 415, 0, 0, 0, 54, 469
"f:\data\learn\javaLearn\note\.history\郭有根-第十三章作业_20220726102446.md", "Markdown", 0, 415, 0, 0, 0, 54, 469
"f:\data\learn\javaLearn\note\.history\郭有根-第十三章作业_20220726102447.md", "Markdown", 0, 415, 0, 0, 0, 54, 469
"f:\data\learn\javaLearn\note\.history\郭有根-第十三章作业_20220726102448.md", "Markdown", 0, 415, 0, 0, 0, 54, 469
"f:\data\learn\javaLearn\note\.history\郭有根-第十三章作业_20220726104543.md", "Markdown", 0, 361, 0, 0, 0, 52, 413
"f:\data\learn\javaLearn\note\.history\郭有根-第十三章作业_20220726104614.md", "Markdown", 0, 415, 0, 0, 0, 54, 469
"f:\data\learn\javaLearn\note\.history\郭有根-第十三章作业_20220726104714.md", "Markdown", 0, 306, 0, 0, 0, 50, 356
"f:\data\learn\javaLearn\note\.history\郭有根-第十三章作业_20220726104745.md", "Markdown", 0, 398, 0, 0, 0, 54, 452
"f:\data\learn\javaLearn\note\.history\郭有根-第十三章作业_20220726104800.md", "Markdown", 0, 416, 0, 0, 0, 56, 472
"f:\data\learn\javaLearn\note\.history\郭有根-第十三章作业_20220726104906.md", "Markdown", 0, 416, 0, 0, 0, 56, 472
"f:\data\learn\javaLearn\note\.history\郭有根-第十三章作业_20220726104907.md", "Markdown", 0, 416, 0, 0, 0, 56, 472
"f:\data\learn\javaLearn\note\.history\郭有根-第十三章作业_20220726105107.md", "Markdown", 0, 416, 0, 0, 0, 56, 472
"f:\data\learn\javaLearn\note\.history\郭有根-第十三章作业_20220726170153.md", "Markdown", 0, 411, 0, 0, 0, 62, 473
"f:\data\learn\javaLearn\note\.history\郭有根-第十三章作业_20220726170159.md", "Markdown", 0, 411, 0, 0, 0, 62, 473
"f:\data\learn\javaLearn\note\.history\郭有根-第十三章作业_20220726170207.md", "Markdown", 0, 411, 0, 0, 0, 62, 473
"f:\data\learn\javaLearn\note\.history\郭有根-第十三章作业_20220726170212.md", "Markdown", 0, 411, 0, 0, 0, 62, 473
"f:\data\learn\javaLearn\note\.history\郭有根-第十三章作业_20220726170434.md", "Markdown", 0, 411, 0, 0, 0, 62, 473
"f:\data\learn\javaLearn\note\.history\郭有根-第十三章作业_20220726170437.md", "Markdown", 0, 411, 0, 0, 0, 62, 473
"f:\data\learn\javaLearn\note\.history\郭有根-第十九次作业_20220805165508.md", "Markdown", 0, 0, 0, 0, 0, 1, 1
"f:\data\learn\javaLearn\note\.history\郭有根-第十九次作业_20220805165517.md", "Markdown", 0, 4, 0, 0, 0, 2, 6
"f:\data\learn\javaLearn\note\.history\郭有根-第十九次作业_20220805165518.md", "Markdown", 0, 10, 0, 0, 0, 2, 12
"f:\data\learn\javaLearn\note\.history\郭有根-第十九次作业_20220805165541.md", "Markdown", 0, 10, 0, 0, 0, 4, 14
"f:\data\learn\javaLearn\note\.history\郭有根-第十九次作业_20220805165646.md", "Markdown", 0, 11, 0, 0, 0, 6, 17
"f:\data\learn\javaLearn\note\.history\郭有根-第十九次作业_20220805165720.md", "Markdown", 0, 14, 0, 0, 0, 8, 22
"f:\data\learn\javaLearn\note\.history\郭有根-第十九次作业_20220805165741.md", "Markdown", 0, 15, 0, 0, 0, 10, 25
"f:\data\learn\javaLearn\note\.history\郭有根-第十九次作业_20220805165842.md", "Markdown", 0, 17, 0, 0, 0, 9, 26
"f:\data\learn\javaLearn\note\.history\郭有根-第十九次作业_20220805165850.md", "Markdown", 0, 17, 0, 0, 0, 9, 26
"f:\data\learn\javaLearn\note\.history\郭有根-第十九次作业_20220805170056.md", "Markdown", 0, 18, 0, 0, 0, 12, 30
"f:\data\learn\javaLearn\note\.history\郭有根-第十九次作业_20220805170134.md", "Markdown", 0, 19, 0, 0, 0, 12, 31
"f:\data\learn\javaLearn\note\.history\郭有根-第十九次作业_20220805170141.md", "Markdown", 0, 19, 0, 0, 0, 12, 31
"f:\data\learn\javaLearn\note\.history\郭有根-第十九次作业_20220805170204.md", "Markdown", 0, 20, 0, 0, 0, 15, 35
"f:\data\learn\javaLearn\note\.history\郭有根-第十九次作业_20220805170234.md", "Markdown", 0, 35, 0, 0, 0, 17, 52
"f:\data\learn\javaLearn\note\.history\郭有根-第十九次作业_20220805170241.md", "Markdown", 0, 35, 0, 0, 0, 17, 52
"f:\data\learn\javaLearn\note\.history\郭有根-第十九次作业_20220805170305.md", "Markdown", 0, 36, 0, 0, 0, 19, 55
"f:\data\learn\javaLearn\note\.history\郭有根-第十九次作业_20220805170324.md", "Markdown", 0, 47, 0, 0, 0, 21, 68
"f:\data\learn\javaLearn\note\.history\郭有根-第十九次作业_20220805170400.md", "Markdown", 0, 47, 0, 0, 0, 21, 68
"f:\data\learn\javaLearn\note\.history\郭有根-第十九次作业_20220805170432.md", "Markdown", 0, 47, 0, 0, 0, 23, 70
"f:\data\learn\javaLearn\note\.history\郭有根-第十九次作业_20220805170459.md", "Markdown", 0, 72, 0, 0, 0, 29, 101
"f:\data\learn\javaLearn\note\.history\郭有根-第十九次作业_20220805170514.md", "Markdown", 0, 73, 0, 0, 0, 30, 103
"f:\data\learn\javaLearn\note\.history\郭有根-第十九次作业_20220805170525.md", "Markdown", 0, 74, 0, 0, 0, 30, 104
"f:\data\learn\javaLearn\note\.history\郭有根-第十九次作业_20220805170542.md", "Markdown", 0, 107, 0, 0, 0, 36, 143
"f:\data\learn\javaLearn\note\.history\郭有根-第十九次作业_20220805170557.md", "Markdown", 0, 108, 0, 0, 0, 35, 143
"f:\data\learn\javaLearn\note\.history\郭有根-第十九次作业_20220805170957.md", "Markdown", 0, 109, 0, 0, 0, 34, 143
"f:\data\learn\javaLearn\note\.history\郭有根-第十九次作业_20220805171021.md", "Markdown", 0, 110, 0, 0, 0, 36, 146
"f:\data\learn\javaLearn\note\.history\郭有根-第十九次作业_20220805171110.md", "Markdown", 0, 112, 0, 0, 0, 37, 149
"f:\data\learn\javaLearn\note\.history\郭有根-第十九次作业_20220805171310.md", "Markdown", 0, 140, 0, 0, 0, 42, 182
"f:\data\learn\javaLearn\note\.history\郭有根-第十九次作业_20220805171334.md", "Markdown", 0, 141, 0, 0, 0, 43, 184
"f:\data\learn\javaLearn\note\.history\郭有根-第十九次作业_20220805171422.md", "Markdown", 0, 141, 0, 0, 0, 45, 186
"f:\data\learn\javaLearn\note\.history\郭有根-第十九次作业_20220805171526.md", "Markdown", 0, 143, 0, 0, 0, 45, 188
"f:\data\learn\javaLearn\note\.history\郭有根-第十九次作业_20220805171549.md", "Markdown", 0, 145, 0, 0, 0, 48, 193
"f:\data\learn\javaLearn\note\.history\郭有根-第十九次作业_20220805171623.md", "Markdown", 0, 180, 0, 0, 0, 52, 232
"f:\data\learn\javaLearn\note\.history\郭有根-第十九次作业_20220805171815.md", "Markdown", 0, 183, 0, 0, 0, 55, 238
"f:\data\learn\javaLearn\note\.history\郭有根-第十九次作业_20220805171843.md", "Markdown", 0, 184, 0, 0, 0, 57, 241
"f:\data\learn\javaLearn\note\.history\郭有根-第十九次作业_20220805171919.md", "Markdown", 0, 192, 0, 0, 0, 58, 250
"f:\data\learn\javaLearn\note\.history\郭有根-第十九次作业_20220805172024.md", "Markdown", 0, 200, 0, 0, 0, 59, 259
"f:\data\learn\javaLearn\note\.history\郭有根-第十九次作业_20220805172130.md", "Markdown", 0, 268, 0, 0, 0, 76, 344
"f:\data\learn\javaLearn\note\.history\郭有根-第十九次作业_20220805172220.md", "Markdown", 0, 318, 0, 0, 0, 83, 401
"f:\data\learn\javaLearn\note\.history\郭有根-第十九次作业_20220805172358.md", "Markdown", 0, 319, 0, 0, 0, 83, 402
"f:\data\learn\javaLearn\note\.history\郭有根-第十九次作业_20220805192855.md", "Markdown", 0, 319, 0, 0, 0, 83, 402
"f:\data\learn\javaLearn\note\.history\郭有根-第十九次作业_20220807010054.md", "Markdown", 0, 319, 0, 0, 0, 83, 402
"f:\data\learn\javaLearn\note\.history\郭有根-第十二章作业_20220722164827.md", "Markdown", 0, 0, 0, 0, 0, 1, 1
"f:\data\learn\javaLearn\note\.history\郭有根-第十二章作业_20220722164828.md", "Markdown", 0, 6, 0, 0, 0, 1, 7
"f:\data\learn\javaLearn\note\.history\郭有根-第十二章作业_20220722164902.md", "Markdown", 0, 10, 0, 0, 0, 4, 14
"f:\data\learn\javaLearn\note\.history\郭有根-第十二章作业_20220722164930.md", "Markdown", 0, 11, 0, 0, 0, 4, 15
"f:\data\learn\javaLearn\note\.history\郭有根-第十二章作业_20220722164946.md", "Markdown", 0, 13, 0, 0, 0, 5, 18
"f:\data\learn\javaLearn\note\.history\郭有根-第十二章作业_20220722165029.md", "Markdown", 0, 15, 0, 0, 0, 7, 22
"f:\data\learn\javaLearn\note\.history\郭有根-第十二章作业_20220722165412.md", "Markdown", 0, 51, 0, 0, 0, 12, 63
"f:\data\learn\javaLearn\note\.history\郭有根-第十二章作业_20220722165737.md", "Markdown", 0, 55, 0, 0, 0, 13, 68
"f:\data\learn\javaLearn\note\.history\郭有根-第十二章作业_20220722170437.md", "Markdown", 0, 55, 0, 0, 0, 14, 69
"f:\data\learn\javaLearn\note\.history\郭有根-第十二章作业_20220723165459.md", "Markdown", 0, 55, 0, 0, 0, 16, 71
"f:\data\learn\javaLearn\note\.history\郭有根-第十二章作业_20220725010208.md", "Markdown", 0, 56, 0, 0, 0, 15, 71
"f:\data\learn\javaLearn\note\.history\郭有根-第十二章作业_20220725010229.md", "Markdown", 0, 56, 0, 0, 0, 15, 71
"f:\data\learn\javaLearn\note\.history\郭有根-第十二章作业_20220725010347.md", "Markdown", 0, 57, 0, 0, 0, 15, 72
"f:\data\learn\javaLearn\note\.history\郭有根-第十二章作业_20220725010836.md", "Markdown", 0, 61, 0, 0, 0, 21, 82
"f:\data\learn\javaLearn\note\.history\郭有根-第十二章作业_20220725011014.md", "Markdown", 0, 61, 0, 0, 0, 21, 82
"f:\data\learn\javaLearn\note\.history\郭有根-第十二章作业_20220725011145.md", "Markdown", 0, 63, 0, 0, 0, 24, 87
"f:\data\learn\javaLearn\note\.history\郭有根-第十二章作业_20220725011517.md", "Markdown", 0, 223, 0, 0, 0, 31, 254
"f:\data\learn\javaLearn\note\.history\郭有根-第十二章作业_20220725011629.md", "Markdown", 0, 252, 0, 0, 0, 34, 286
"f:\data\learn\javaLearn\note\.history\郭有根-第十二章作业_20220725012024.md", "Markdown", 0, 253, 0, 0, 0, 35, 288
"f:\data\learn\javaLearn\note\.history\郭有根-第十二章作业_20220725012035.md", "Markdown", 0, 254, 0, 0, 0, 35, 289
"f:\data\learn\javaLearn\note\.history\郭有根-第十二章作业_20220725012246.md", "Markdown", 0, 254, 0, 0, 0, 35, 289
"f:\data\learn\javaLearn\note\.history\郭有根-第十二章作业_20220725012553.md", "Markdown", 0, 254, 0, 0, 0, 33, 287
"f:\data\learn\javaLearn\note\.history\郭有根-第十二章作业_20220725012834.md", "Markdown", 0, 255, 0, 0, 0, 34, 289
"f:\data\learn\javaLearn\note\.history\郭有根-第十二章作业_20220725012856.md", "Markdown", 0, 255, 0, 0, 0, 34, 289
"f:\data\learn\javaLearn\note\.history\郭有根-第十二章作业_20220725013052.md", "Markdown", 0, 255, 0, 0, 0, 34, 289
"f:\data\learn\javaLearn\note\.history\郭有根-第十二章作业_20220725013207.md", "Markdown", 0, 255, 0, 0, 0, 34, 289
"f:\data\learn\javaLearn\note\.history\郭有根-第十二章作业_20220725013536.md", "Markdown", 0, 255, 0, 0, 0, 34, 289
"f:\data\learn\javaLearn\note\.history\郭有根-第十二章作业_20220725013630.md", "Markdown", 0, 255, 0, 0, 0, 34, 289
"f:\data\learn\javaLearn\note\.history\郭有根-第十二章作业_20220725013832.md", "Markdown", 0, 255, 0, 0, 0, 34, 289
"f:\data\learn\javaLearn\note\.history\郭有根-第十二章作业_20220725014021.md", "Markdown", 0, 255, 0, 0, 0, 34, 289
"f:\data\learn\javaLearn\note\.history\郭有根-第十二章作业_20220725014502.md", "Markdown", 0, 255, 0, 0, 0, 34, 289
"f:\data\learn\javaLearn\note\.history\郭有根-第十二章作业_20220725014628.md", "Markdown", 0, 255, 0, 0, 0, 36, 291
"f:\data\learn\javaLearn\note\.history\郭有根-第十二章作业_20220725014735.md", "Markdown", 0, 256, 0, 0, 0, 35, 291
"f:\data\learn\javaLearn\note\.history\郭有根-第十二章作业_20220725014831.md", "Markdown", 0, 256, 0, 0, 0, 35, 291
"f:\data\learn\javaLearn\note\.history\郭有根-第十二章作业_20220725014959.md", "Markdown", 0, 257, 0, 0, 0, 35, 292
"f:\data\learn\javaLearn\note\.history\郭有根-第十二章作业_20220725015036.md", "Markdown", 0, 257, 0, 0, 0, 35, 292
"f:\data\learn\javaLearn\note\.history\郭有根-第十二章作业_20220725015047.md", "Markdown", 0, 257, 0, 0, 0, 35, 292
"f:\data\learn\javaLearn\note\.history\郭有根-第十二章作业_20220725015048.md", "Markdown", 0, 257, 0, 0, 0, 35, 292
"f:\data\learn\javaLearn\note\.history\郭有根-第十二章作业_20220725015054.md", "Markdown", 0, 257, 0, 0, 0, 35, 292
"f:\data\learn\javaLearn\note\.history\郭有根-第十二章作业_20220725084527.md", "Markdown", 0, 257, 0, 0, 0, 36, 293
"f:\data\learn\javaLearn\note\.history\郭有根-第十二章作业_20220725094708.md", "Markdown", 0, 257, 0, 0, 0, 36, 293
"f:\data\learn\javaLearn\note\.history\郭有根-第十二章作业_20220725095253.md", "Markdown", 0, 256, 0, 0, 0, 35, 291
"f:\data\learn\javaLearn\note\.history\郭有根-第十二章作业_20220725095900.md", "Markdown", 0, 257, 0, 0, 0, 34, 291
"f:\data\learn\javaLearn\note\.history\郭有根-第十二章作业_20220725095921.md", "Markdown", 0, 257, 0, 0, 0, 34, 291
"f:\data\learn\javaLearn\note\.history\郭有根-第十二章作业_20220725100007.md", "Markdown", 0, 256, 0, 0, 0, 35, 291
"f:\data\learn\javaLearn\note\.history\郭有根-第十五章作业_20220728100244.md", "Markdown", 0, 0, 0, 0, 0, 1, 1
"f:\data\learn\javaLearn\note\.history\郭有根-第十五章作业_20220728100246.md", "Markdown", 0, 6, 0, 0, 0, 1, 7
"f:\data\learn\javaLearn\note\.history\郭有根-第十五章作业_20220728100258.md", "Markdown", 0, 10, 0, 0, 0, 2, 12
"f:\data\learn\javaLearn\note\.history\郭有根-第十五章作业_20220728100339.md", "Markdown", 0, 10, 0, 0, 0, 4, 14
"f:\data\learn\javaLearn\note\.history\郭有根-第十五章作业_20220728100417.md", "Markdown", 0, 12, 0, 0, 0, 5, 17
"f:\data\learn\javaLearn\note\.history\郭有根-第十五章作业_20220728100442.md", "Markdown", 0, 13, 0, 0, 0, 6, 19
"f:\data\learn\javaLearn\note\.history\郭有根-第十五章作业_20220728100459.md", "Markdown", 0, 14, 0, 0, 0, 7, 21
"f:\data\learn\javaLearn\note\.history\郭有根-第十五章作业_20220728100512.md", "Markdown", 0, 14, 0, 0, 0, 9, 23
"f:\data\learn\javaLearn\note\.history\郭有根-第十五章作业_20220728100600.md", "Markdown", 0, 17, 0, 0, 0, 10, 27
"f:\data\learn\javaLearn\note\.history\郭有根-第十五章作业_20220728100713.md", "Markdown", 0, 18, 0, 0, 0, 10, 28
"f:\data\learn\javaLearn\note\.history\郭有根-第十五章作业_20220728101151.md", "Markdown", 0, 18, 0, 0, 0, 13, 31
"f:\data\learn\javaLearn\note\.history\郭有根-第十五章作业_20220728104501.md", "Markdown", 0, 31, 0, 0, 0, 12, 43
"f:\data\learn\javaLearn\note\.history\郭有根-第十五章作业_20220728230030.md", "Markdown", 0, 31, 0, 0, 0, 12, 43
"f:\data\learn\javaLearn\note\.history\郭有根-第十五章作业_20220728230446.md", "Markdown", 0, 31, 0, 0, 0, 12, 43
"f:\data\learn\javaLearn\note\.history\郭有根-第十五章作业_20220728230525.md", "Markdown", 0, 32, 0, 0, 0, 13, 45
"f:\data\learn\javaLearn\note\.history\郭有根-第十五章作业_20220728230603.md", "Markdown", 0, 39, 0, 0, 0, 16, 55
"f:\data\learn\javaLearn\note\.history\郭有根-第十五章作业_20220728230640.md", "Markdown", 0, 48, 0, 0, 0, 17, 65
"f:\data\learn\javaLearn\note\.history\郭有根-第十五章作业_20220728230706.md", "Markdown", 0, 48, 0, 0, 0, 19, 67
"f:\data\learn\javaLearn\note\.history\郭有根-第十五章作业_20220728230741.md", "Markdown", 0, 61, 0, 0, 0, 21, 82
"f:\data\learn\javaLearn\note\.history\郭有根-第十五章作业_20220728230836.md", "Markdown", 0, 62, 0, 0, 0, 22, 84
"f:\data\learn\javaLearn\note\.history\郭有根-第十五章作业_20220728230924.md", "Markdown", 0, 65, 0, 0, 0, 24, 89
"f:\data\learn\javaLearn\note\.history\郭有根-第十五章作业_20220728231020.md", "Markdown", 0, 65, 0, 0, 0, 24, 89
"f:\data\learn\javaLearn\note\.history\郭有根-第十五章作业_20220729011513.md", "Markdown", 0, 65, 0, 0, 0, 24, 89
"f:\data\learn\javaLearn\note\.history\郭有根-第十五章作业_20220729015003.md", "Markdown", 0, 68, 0, 0, 0, 25, 93
"f:\data\learn\javaLearn\note\.history\郭有根-第十五章作业_20220729015102.md", "Markdown", 0, 68, 0, 0, 0, 25, 93
"f:\data\learn\javaLearn\note\.history\郭有根-第十五章作业_20220729015122.md", "Markdown", 0, 68, 0, 0, 0, 25, 93
"f:\data\learn\javaLearn\note\.history\郭有根-第十五章作业_20220729015240.md", "Markdown", 0, 69, 0, 0, 0, 27, 96
"f:\data\learn\javaLearn\note\.history\郭有根-第十五章作业_20220729015420.md", "Markdown", 0, 69, 0, 0, 0, 27, 96
"f:\data\learn\javaLearn\note\.history\郭有根-第十五章作业_20220729015607.md", "Markdown", 0, 115, 0, 0, 0, 32, 147
"f:\data\learn\javaLearn\note\.history\郭有根-第十五章作业_20220729015711.md", "Markdown", 0, 165, 0, 0, 0, 41, 206
"f:\data\learn\javaLearn\note\.history\郭有根-第十五章作业_20220729015957.md", "Markdown", 0, 166, 0, 0, 0, 42, 208
"f:\data\learn\javaLearn\note\.history\郭有根-第十五章作业_20220729020122.md", "Markdown", 0, 166, 0, 0, 0, 42, 208
"f:\data\learn\javaLearn\note\.history\郭有根-第十五章作业_20220729020507.md", "Markdown", 0, 167, 0, 0, 0, 43, 210
"f:\data\learn\javaLearn\note\.history\郭有根-第十五章作业_20220729020546.md", "Markdown", 0, 168, 0, 0, 0, 44, 212
"f:\data\learn\javaLearn\note\.history\郭有根-第十五章作业_20220729020617.md", "Markdown", 0, 169, 0, 0, 0, 43, 212
"f:\data\learn\javaLearn\note\.history\郭有根-第十五章作业_20220729020835.md", "Markdown", 0, 169, 0, 0, 0, 44, 213
"f:\data\learn\javaLearn\note\.history\郭有根-第十五章作业_20220729021111.md", "Markdown", 0, 167, 0, 0, 0, 43, 210
"f:\data\learn\javaLearn\note\.history\郭有根-第十五章作业_20220729021331.md", "Markdown", 0, 172, 0, 0, 0, 45, 217
"f:\data\learn\javaLearn\note\.history\郭有根-第十五章作业_20220729021546.md", "Markdown", 0, 175, 0, 0, 0, 47, 222
"f:\data\learn\javaLearn\note\.history\郭有根-第十五章作业_20220729021627.md", "Markdown", 0, 176, 0, 0, 0, 48, 224
"f:\data\learn\javaLearn\note\.history\郭有根-第十五章作业_20220729022026.md", "Markdown", 0, 181, 0, 0, 0, 49, 230
"f:\data\learn\javaLearn\note\.history\郭有根-第十五章作业_20220729022037.md", "Markdown", 0, 181, 0, 0, 0, 49, 230
"f:\data\learn\javaLearn\note\.history\郭有根-第十八章作业_20220802143603.md", "Markdown", 0, 526, 0, 0, 0, 111, 637
"f:\data\learn\javaLearn\note\.history\郭有根-第十八章作业_20220805173030.md", "Markdown", 0, 526, 0, 0, 0, 111, 637
"f:\data\learn\javaLearn\note\.history\郭有根-第十八章作业_20220805185804.md", "Markdown", 0, 526, 0, 0, 0, 111, 637
"f:\data\learn\javaLearn\note\.history\郭有根-第十八章作业_20220805185924.md", "Markdown", 0, 526, 0, 0, 0, 111, 637
"f:\data\learn\javaLearn\note\.history\郭有根-第十八章作业_20220805190227.md", "Markdown", 0, 526, 0, 0, 0, 111, 637
"f:\data\learn\javaLearn\note\.history\郭有根-第十八章作业_20220805192642.md", "Markdown", 0, 526, 0, 0, 0, 111, 637
"f:\data\learn\javaLearn\note\.history\郭有根-第十八章作业_20220805192715.md", "Markdown", 0, 526, 0, 0, 0, 111, 637
"f:\data\learn\javaLearn\note\.history\郭有根-第十八章作业_20220805192853.md", "Markdown", 0, 530, 0, 0, 0, 109, 639
"f:\data\learn\javaLearn\note\.history\郭有根-第十八章作业_20220807011136.md", "Markdown", 0, 530, 0, 0, 0, 109, 639
"f:\data\learn\javaLearn\note\.history\郭有根-第十六章作业_20220729090945.md", "Markdown", 0, 0, 0, 0, 0, 1, 1
"f:\data\learn\javaLearn\note\.history\郭有根-第十六章作业_20220729090946.md", "Markdown", 0, 6, 0, 0, 0, 1, 7
"f:\data\learn\javaLearn\note\.history\郭有根-第十六章作业_20220729091050.md", "Markdown", 0, 10, 0, 0, 0, 5, 15
"f:\data\learn\javaLearn\note\.history\郭有根-第十六章作业_20220729091116.md", "Markdown", 0, 12, 0, 0, 0, 5, 17
"f:\data\learn\javaLearn\note\.history\郭有根-第十六章作业_20220729091132.md", "Markdown", 0, 13, 0, 0, 0, 6, 19
"f:\data\learn\javaLearn\note\.history\郭有根-第十六章作业_20220729091138.md", "Markdown", 0, 13, 0, 0, 0, 6, 19
"f:\data\learn\javaLearn\note\.history\郭有根-第十六章作业_20220729091220.md", "Markdown", 0, 17, 0, 0, 0, 10, 27
"f:\data\learn\javaLearn\note\.history\郭有根-第十六章作业_20220729091228.md", "Markdown", 0, 17, 0, 0, 0, 10, 27
"f:\data\learn\javaLearn\note\.history\郭有根-第十六章作业_20220729091236.md", "Markdown", 0, 17, 0, 0, 0, 10, 27
"f:\data\learn\javaLearn\note\.history\郭有根-第十六章作业_20220729091312.md", "Markdown", 0, 17, 0, 0, 0, 10, 27
"f:\data\learn\javaLearn\note\.history\郭有根-第十六章作业_20220729091358.md", "Markdown", 0, 23, 0, 0, 0, 15, 38
"f:\data\learn\javaLearn\note\.history\郭有根-第十六章作业_20220729091421.md", "Markdown", 0, 25, 0, 0, 0, 16, 41
"f:\data\learn\javaLearn\note\.history\郭有根-第十六章作业_20220729091445.md", "Markdown", 0, 56, 0, 0, 0, 15, 71
"f:\data\learn\javaLearn\note\.history\郭有根-第十六章作业_20220729091521.md", "Markdown", 0, 66, 0, 0, 0, 16, 82
"f:\data\learn\javaLearn\note\.history\郭有根-第十六章作业_20220729091553.md", "Markdown", 0, 69, 0, 0, 0, 18, 87
"f:\data\learn\javaLearn\note\.history\郭有根-第十六章作业_20220729091725.md", "Markdown", 0, 81, 0, 0, 0, 20, 101
"f:\data\learn\javaLearn\note\.history\郭有根-第十六章作业_20220729091754.md", "Markdown", 0, 83, 0, 0, 0, 20, 103
"f:\data\learn\javaLearn\note\.history\郭有根-第十六章作业_20220729091812.md", "Markdown", 0, 84, 0, 0, 0, 22, 106
"f:\data\learn\javaLearn\note\.history\郭有根-第十六章作业_20220729092328.md", "Markdown", 0, 94, 0, 0, 0, 23, 117
"f:\data\learn\javaLearn\note\.history\郭有根-第十六章作业_20220729092418.md", "Markdown", 0, 97, 0, 0, 0, 25, 122
"f:\data\learn\javaLearn\note\.history\郭有根-第十六章作业_20220729092509.md", "Markdown", 0, 103, 0, 0, 0, 29, 132
"f:\data\learn\javaLearn\note\.history\郭有根-第十六章作业_20220729092717.md", "Markdown", 0, 124, 0, 0, 0, 30, 154
"f:\data\learn\javaLearn\note\.history\郭有根-第十六章作业_20220729092758.md", "Markdown", 0, 125, 0, 0, 0, 33, 158
"f:\data\learn\javaLearn\note\.history\郭有根-第十六章作业_20220729093254.md", "Markdown", 0, 137, 0, 0, 0, 33, 170
"f:\data\learn\javaLearn\note\.history\郭有根-第十六章作业_20220730005743.md", "Markdown", 0, 137, 0, 0, 0, 33, 170
"f:\data\learn\javaLearn\note\.history\郭有根-第十六章作业_20220730011636.md", "Markdown", 0, 137, 0, 0, 0, 33, 170
"f:\data\learn\javaLearn\note\.history\郭有根-第十六章作业_20220730165612.md", "Markdown", 0, 137, 0, 0, 0, 33, 170
"f:\data\learn\javaLearn\note\.history\郭有根-第十六章作业_20220801022018.md", "Markdown", 0, 137, 0, 0, 0, 35, 172
"f:\data\learn\javaLearn\note\.history\郭有根-第十六章作业_20220801022314.md", "Markdown", 0, 138, 0, 0, 0, 35, 173
"f:\data\learn\javaLearn\note\.history\郭有根-第十六章作业_20220801022443.md", "Markdown", 0, 138, 0, 0, 0, 35, 173
"f:\data\learn\javaLearn\note\.history\郭有根-第十六章作业_20220801022541.md", "Markdown", 0, 146, 0, 0, 0, 37, 183
"f:\data\learn\javaLearn\note\.history\郭有根-第十六章作业_20220801022605.md", "Markdown", 0, 146, 0, 0, 0, 37, 183
"f:\data\learn\javaLearn\note\.history\郭有根-第十六章作业_20220801022716.md", "Markdown", 0, 153, 0, 0, 0, 39, 192
"f:\data\learn\javaLearn\note\.history\郭有根-第十六章作业_20220801022738.md", "Markdown", 0, 154, 0, 0, 0, 39, 193
"f:\data\learn\javaLearn\note\.history\郭有根-第十六章作业_20220801022901.md", "Markdown", 0, 160, 0, 0, 0, 39, 199
"f:\data\learn\javaLearn\note\.history\郭有根-第十六章作业_20220801023106.md", "Markdown", 0, 163, 0, 0, 0, 44, 207
"f:\data\learn\javaLearn\note\.history\郭有根-第十六章作业_20220801025059.md", "Markdown", 0, 164, 0, 0, 0, 43, 207
"f:\data\learn\javaLearn\note\.history\郭有根-第十六章作业_20220801025239.md", "Markdown", 0, 164, 0, 0, 0, 43, 207
"f:\data\learn\javaLearn\note\.history\郭有根-第十六章作业_20220801025553.md", "Markdown", 0, 165, 0, 0, 0, 46, 211
"f:\data\learn\javaLearn\note\.history\郭有根-第十六章作业_20220801025747.md", "Markdown", 0, 166, 0, 0, 0, 45, 211
"f:\data\learn\javaLearn\note\.history\郭有根-第十六章作业_20220801025909.md", "Markdown", 0, 167, 0, 0, 0, 46, 213
"f:\data\learn\javaLearn\note\.history\郭有根-第十六章作业_20220801025938.md", "Markdown", 0, 167, 0, 0, 0, 48, 215
"f:\data\learn\javaLearn\note\.history\郭有根-第十六章作业_20220801030452.md", "Markdown", 0, 170, 0, 0, 0, 47, 217
"f:\data\learn\javaLearn\note\.history\郭有根-第十六章作业_20220801031146.md", "Markdown", 0, 171, 0, 0, 0, 48, 219
"f:\data\learn\javaLearn\note\.history\郭有根-第十六章作业_20220801031238.md", "Markdown", 0, 171, 0, 0, 0, 50, 221
"f:\data\learn\javaLearn\note\.history\郭有根-第十六章作业_20220801032459.md", "Markdown", 0, 172, 0, 0, 0, 50, 222
"f:\data\learn\javaLearn\note\.history\郭有根-第十六章作业_20220801032618.md", "Markdown", 0, 173, 0, 0, 0, 49, 222
"f:\data\learn\javaLearn\note\.history\郭有根-第十六章作业_20220801032704.md", "Markdown", 0, 175, 0, 0, 0, 49, 224
"f:\data\learn\javaLearn\note\.history\郭有根-第十六章作业_20220801032856.md", "Markdown", 0, 176, 0, 0, 0, 50, 226
"f:\data\learn\javaLearn\note\.history\郭有根-第十六章作业_20220801032940.md", "Markdown", 0, 176, 0, 0, 0, 51, 227
"f:\data\learn\javaLearn\note\.history\郭有根-第十六章作业_20220801033022.md", "Markdown", 0, 175, 0, 0, 0, 50, 225
"f:\data\learn\javaLearn\note\.history\郭有根-第十六章作业_20220801033136.md", "Markdown", 0, 177, 0, 0, 0, 54, 231
"f:\data\learn\javaLearn\note\.history\郭有根-第十六章作业_20220801033230.md", "Markdown", 0, 191, 0, 0, 0, 62, 253
"f:\data\learn\javaLearn\note\.history\郭有根-第十六章作业_20220801033438.md", "Markdown", 0, 381, 0, 0, 0, 82, 463
"f:\data\learn\javaLearn\note\.history\郭有根-第十六章作业_20220801033631.md", "Markdown", 0, 382, 0, 0, 0, 83, 465
"f:\data\learn\javaLearn\note\.history\郭有根-第十六章作业_20220801033746.md", "Markdown", 0, 381, 0, 0, 0, 85, 466
"f:\data\learn\javaLearn\note\.history\郭有根-第十六章作业_20220801034038.md", "Markdown", 0, 382, 0, 0, 0, 85, 467
"f:\data\learn\javaLearn\note\.history\郭有根-第十六章作业_20220801034139.md", "Markdown", 0, 384, 0, 0, 0, 84, 468
"f:\data\learn\javaLearn\note\.history\郭有根-第十六章作业_20220801034318.md", "Markdown", 0, 384, 0, 0, 0, 84, 468
"f:\data\learn\javaLearn\note\.history\郭有根-第十六章作业_20220801034501.md", "Markdown", 0, 443, 0, 0, 0, 92, 535
"f:\data\learn\javaLearn\note\.history\郭有根-第十六章作业_20220801034655.md", "Markdown", 0, 474, 0, 0, 0, 103, 577
"f:\data\learn\javaLearn\note\.history\郭有根-第十六章作业_20220801034915.md", "Markdown", 0, 512, 0, 0, 0, 105, 617
"f:\data\learn\javaLearn\note\.history\郭有根-第十六章作业_20220801035023.md", "Markdown", 0, 512, 0, 0, 0, 105, 617
"f:\data\learn\javaLearn\note\.history\郭有根-第十六章作业_20220801035237.md", "Markdown", 0, 512, 0, 0, 0, 105, 617
"f:\data\learn\javaLearn\note\.history\郭有根-第十六章作业_20220801035257.md", "Markdown", 0, 512, 0, 0, 0, 105, 617
"f:\data\learn\javaLearn\note\.history\郭有根-第十六章作业_20220801035412.md", "Markdown", 0, 512, 0, 0, 0, 105, 617
"f:\data\learn\javaLearn\note\.history\郭有根-第十六章作业_20220801035449.md", "Markdown", 0, 512, 0, 0, 0, 105, 617
"f:\data\learn\javaLearn\note\.history\郭有根-第十六章作业_20220801112630.md", "Markdown", 0, 512, 0, 0, 0, 105, 617
"f:\data\learn\javaLearn\note\.history\郭有根-第十六章作业_20220801112807.md", "Markdown", 0, 512, 0, 0, 0, 105, 617
"f:\data\learn\javaLearn\note\.history\郭有根-第十四章作业_20220726102952.md", "Markdown", 0, 0, 0, 0, 0, 1, 1
"f:\data\learn\javaLearn\note\.history\郭有根-第十四章作业_20220726102954.md", "Markdown", 0, 6, 0, 0, 0, 1, 7
"f:\data\learn\javaLearn\note\.history\郭有根-第十四章作业_20220726103015.md", "Markdown", 0, 10, 0, 0, 0, 3, 13
"f:\data\learn\javaLearn\note\.history\郭有根-第十四章作业_20220726103156.md", "Markdown", 0, 12, 0, 0, 0, 5, 17
"f:\data\learn\javaLearn\note\.history\郭有根-第十四章作业_20220726103211.md", "Markdown", 0, 13, 0, 0, 0, 6, 19
"f:\data\learn\javaLearn\note\.history\郭有根-第十四章作业_20220726103252.md", "Markdown", 0, 15, 0, 0, 0, 8, 23
"f:\data\learn\javaLearn\note\.history\郭有根-第十四章作业_20220726103302.md", "Markdown", 0, 15, 0, 0, 0, 8, 23
"f:\data\learn\javaLearn\note\.history\郭有根-第十四章作业_20220726103321.md", "Markdown", 0, 16, 0, 0, 0, 11, 27
"f:\data\learn\javaLearn\note\.history\郭有根-第十四章作业_20220726103406.md", "Markdown", 0, 30, 0, 0, 0, 11, 41
"f:\data\learn\javaLearn\note\.history\郭有根-第十四章作业_20220726103423.md", "Markdown", 0, 31, 0, 0, 0, 13, 44
"f:\data\learn\javaLearn\note\.history\郭有根-第十四章作业_20220726103549.md", "Markdown", 0, 38, 0, 0, 0, 14, 52
"f:\data\learn\javaLearn\note\.history\郭有根-第十四章作业_20220726103712.md", "Markdown", 0, 38, 0, 0, 0, 15, 53
"f:\data\learn\javaLearn\note\.history\郭有根-第十四章作业_20220726105147.md", "Markdown", 0, 40, 0, 0, 0, 16, 56
"f:\data\learn\javaLearn\note\.history\郭有根-第十四章作业_20220726105216.md", "Markdown", 0, 47, 0, 0, 0, 17, 64
"f:\data\learn\javaLearn\note\.history\郭有根-第十四章作业_20220726105232.md", "Markdown", 0, 49, 0, 0, 0, 19, 68
"f:\data\learn\javaLearn\note\.history\郭有根-第十四章作业_20220726105356.md", "Markdown", 0, 56, 0, 0, 0, 19, 75
"f:\data\learn\javaLearn\note\.history\郭有根-第十四章作业_20220726105407.md", "Markdown", 0, 57, 0, 0, 0, 20, 77
"f:\data\learn\javaLearn\note\.history\郭有根-第十四章作业_20220726105420.md", "Markdown", 0, 58, 0, 0, 0, 21, 79
"f:\data\learn\javaLearn\note\.history\郭有根-第十四章作业_20220726105430.md", "Markdown", 0, 63, 0, 0, 0, 21, 84
"f:\data\learn\javaLearn\note\.history\郭有根-第十四章作业_20220726105505.md", "Markdown", 0, 62, 0, 0, 0, 21, 83
"f:\data\learn\javaLearn\note\.history\郭有根-第十四章作业_20220726105547.md", "Markdown", 0, 73, 0, 0, 0, 22, 95
"f:\data\learn\javaLearn\note\.history\郭有根-第十四章作业_20220727235724.md", "Markdown", 0, 73, 0, 0, 0, 22, 95
"f:\data\learn\javaLearn\note\.history\郭有根-第十四章作业_20220728012201.md", "Markdown", 0, 73, 0, 0, 0, 23, 96
"f:\data\learn\javaLearn\note\.history\郭有根-第十四章作业_20220728012224.md", "Markdown", 0, 74, 0, 0, 0, 25, 99
"f:\data\learn\javaLearn\note\.history\郭有根-第十四章作业_20220728012417.md", "Markdown", 0, 75, 0, 0, 0, 24, 99
"f:\data\learn\javaLearn\note\.history\郭有根-第十四章作业_20220728012446.md", "Markdown", 0, 76, 0, 0, 0, 26, 102
"f:\data\learn\javaLearn\note\.history\郭有根-第十四章作业_20220728012703.md", "Markdown", 0, 78, 0, 0, 0, 26, 104
"f:\data\learn\javaLearn\note\.history\郭有根-第十四章作业_20220728012754.md", "Markdown", 0, 79, 0, 0, 0, 28, 107
"f:\data\learn\javaLearn\note\.history\郭有根-第十四章作业_20220728012858.md", "Markdown", 0, 122, 0, 0, 0, 30, 152
"f:\data\learn\javaLearn\note\.history\郭有根-第十四章作业_20220728012951.md", "Markdown", 0, 122, 0, 0, 0, 32, 154
"f:\data\learn\javaLearn\note\.history\郭有根-第十四章作业_20220728013132.md", "Markdown", 0, 123, 0, 0, 0, 32, 155
"f:\data\learn\javaLearn\note\.history\郭有根-第十四章作业_20220728013223.md", "Markdown", 0, 124, 0, 0, 0, 32, 156
"f:\data\learn\javaLearn\note\.history\郭有根-第十四章作业_20220728013337.md", "Markdown", 0, 125, 0, 0, 0, 31, 156
"f:\data\learn\javaLearn\note\.history\郭有根-第十四章作业_20220728013358.md", "Markdown", 0, 126, 0, 0, 0, 32, 158
"f:\data\learn\javaLearn\note\.history\郭有根-第十四章作业_20220728013430.md", "Markdown", 0, 127, 0, 0, 0, 34, 161
"f:\data\learn\javaLearn\note\.history\郭有根-第十四章作业_20220728013713.md", "Markdown", 0, 178, 0, 0, 0, 40, 218
"f:\data\learn\javaLearn\note\.history\郭有根-第十四章作业_20220728014006.md", "Markdown", 0, 179, 0, 0, 0, 39, 218
"f:\data\learn\javaLearn\note\.history\郭有根-第十四章作业_20220728014010.md", "Markdown", 0, 179, 0, 0, 0, 39, 218
"f:\data\learn\javaLearn\note\.history\郭有根-第十四章作业_20220728014011.md", "Markdown", 0, 179, 0, 0, 0, 39, 218
"f:\data\learn\javaLearn\note\.history\郭有根-第十四章作业_20220728091415.md", "Markdown", 0, 179, 0, 0, 0, 39, 218
"f:\data\learn\javaLearn\note\.history\郭有根-第十章作业_20220722091047.md", "Markdown", 0, 0, 0, 0, 0, 1, 1
"f:\data\learn\javaLearn\note\.history\郭有根-第十章作业_20220722091049.md", "Markdown", 0, 6, 0, 0, 0, 1, 7
"f:\data\learn\javaLearn\note\.history\郭有根-第十章作业_20220722091216.md", "Markdown", 0, 9, 0, 0, 0, 4, 13
"f:\data\learn\javaLearn\note\.history\郭有根-第十章作业_20220722091233.md", "Markdown", 0, 18, 0, 0, 0, 11, 29
"f:\data\learn\javaLearn\note\.history\郭有根-第十章作业_20220722091240.md", "Markdown", 0, 18, 0, 0, 0, 11, 29
"f:\data\learn\javaLearn\note\.history\郭有根-第十章作业_20220722091419.md", "Markdown", 0, 27, 0, 0, 0, 11, 38
"f:\data\learn\javaLearn\note\.history\郭有根-第十章作业_20220722091444.md", "Markdown", 0, 27, 0, 0, 0, 12, 39
"f:\data\learn\javaLearn\note\.history\郭有根-第十章作业_20220722092330.md", "Markdown", 0, 41, 0, 0, 0, 12, 53
"f:\data\learn\javaLearn\note\.history\郭有根-第十章作业_20220722092550.md", "Markdown", 0, 43, 0, 0, 0, 12, 55
"f:\data\learn\javaLearn\note\.history\郭有根-第十章作业_20220722092611.md", "Markdown", 0, 43, 0, 0, 0, 13, 56
"f:\data\learn\javaLearn\note\.history\郭有根-第十章作业_20220722092703.md", "Markdown", 0, 50, 0, 0, 0, 14, 64
"f:\data\learn\javaLearn\note\.history\郭有根-第十章作业_20220722092842.md", "Markdown", 0, 53, 0, 0, 0, 16, 69
"f:\data\learn\javaLearn\note\.history\郭有根-第十章作业_20220722092955.md", "Markdown", 0, 53, 0, 0, 0, 17, 70
"f:\data\learn\javaLearn\note\.history\郭有根-第十章作业_20220722093100.md", "Markdown", 0, 54, 0, 0, 0, 18, 72
"f:\data\learn\javaLearn\note\.history\郭有根-第十章作业_20220722093231.md", "Markdown", 0, 84, 0, 0, 0, 23, 107
"f:\data\learn\javaLearn\note\.history\郭有根-第十章作业_20220722093253.md", "Markdown", 0, 81, 0, 0, 0, 21, 102
"f:\data\learn\javaLearn\note\.history\郭有根-第十章作业_20220722093319.md", "Markdown", 0, 81, 0, 0, 0, 21, 102
"f:\data\learn\javaLearn\note\.history\郭有根-第十章作业_20220722095822.md", "Markdown", 0, 82, 0, 0, 0, 21, 103
"f:\data\learn\javaLearn\note\.history\郭有根-第十章作业_20220722095839.md", "Markdown", 0, 82, 0, 0, 0, 22, 104
"f:\data\learn\javaLearn\note\.history\郭有根-第十章作业_20220722100020.md", "Markdown", 0, 82, 0, 0, 0, 22, 104
"f:\data\learn\javaLearn\note\.history\郭有根-第十章作业_20220722100035.md", "Markdown", 0, 83, 0, 0, 0, 21, 104
"f:\data\learn\javaLearn\note\.history\郭有根-第十章作业_20220722100055.md", "Markdown", 0, 83, 0, 0, 0, 23, 106
"f:\data\learn\javaLearn\note\.history\郭有根-第十章作业_20220722100214.md", "Markdown", 0, 121, 0, 0, 0, 28, 149
"f:\data\learn\javaLearn\note\.history\郭有根-第十章作业_20220722100259.md", "Markdown", 0, 148, 0, 0, 0, 35, 183
"f:\data\learn\javaLearn\note\.history\郭有根-第十章作业_20220722100359.md", "Markdown", 0, 150, 0, 0, 0, 35, 185
"f:\data\learn\javaLearn\note\.history\郭有根-第十章作业_20220722100440.md", "Markdown", 0, 151, 0, 0, 0, 36, 187
"f:\data\learn\javaLearn\note\.history\郭有根-第十章作业_20220722100510.md", "Markdown", 0, 217, 0, 0, 0, 53, 270
"f:\data\learn\javaLearn\note\.history\郭有根-第十章作业_20220722100553.md", "Markdown", 0, 233, 0, 0, 0, 56, 289
"f:\data\learn\javaLearn\note\.history\郭有根-第十章作业_20220722100637.md", "Markdown", 0, 234, 0, 0, 0, 58, 292
"f:\data\learn\javaLearn\note\.history\郭有根-第十章作业_20220722100657.md", "Markdown", 0, 234, 0, 0, 0, 59, 293
"f:\data\learn\javaLearn\note\.history\郭有根-第十章作业_20220722100726.md", "Markdown", 0, 347, 0, 0, 0, 70, 417
"f:\data\learn\javaLearn\note\.history\郭有根-第十章作业_20220722100816.md", "Markdown", 0, 389, 0, 0, 0, 76, 465
"f:\data\learn\javaLearn\note\.history\郭有根-第十章作业_20220722100958.md", "Markdown", 0, 390, 0, 0, 0, 75, 465
"f:\data\learn\javaLearn\note\.history\郭有根-第十章作业_20220722101204.md", "Markdown", 0, 390, 0, 0, 0, 75, 465
"f:\data\learn\javaLearn\note\.history\郭有根-第十章作业_20220723165536.md", "Markdown", 0, 391, 0, 0, 0, 74, 465
"f:\data\learn\javaLearn\note\.history\郭有根-第十章作业_20220723165731.md", "Markdown", 0, 390, 0, 0, 0, 74, 464
"f:\data\learn\javaLearn\note\README.md", "Markdown", 0, 0, 0, 0, 0, 1, 1
"f:\data\learn\javaLearn\note\journals\2022_07_23.md", "Markdown", 0, 2, 0, 0, 0, 0, 2
"f:\data\learn\javaLearn\note\logseq\config.edn", "Clojure", 0, 0, 0, 57, 148, 39, 244
"f:\data\learn\javaLearn\note\logseq\custom.css", "CSS", 0, 0, 0, 0, 0, 1, 1
"f:\data\learn\javaLearn\note\logseq\metadata.edn", "Clojure", 0, 0, 0, 1, 0, 0, 1
"f:\data\learn\javaLearn\note\logseq\pages-metadata.edn", "Clojure", 0, 0, 0, 60, 0, 1, 61
"f:\data\learn\javaLearn\note\pages\contents.md", "Markdown", 0, 1, 0, 0, 0, 0, 1
"f:\data\learn\javaLearn\note\test.drawio", "Draw.io", 13, 0, 0, 0, 0, 0, 13
"Total", "-", 26, 77028, 0, 118, 148, 16977, 94297