"filename", "language", "Markdown", "comment", "blank", "total"
"f:\data\learn\javaLearn\note\.history\郭有根-第十一章作业_20220721135542.md", "Markdown", 0, 0, -1, -1
"f:\data\learn\javaLearn\note\.history\郭有根-第十一章作业_20220721135544.md", "Markdown", -6, 0, -1, -7
"f:\data\learn\javaLearn\note\.history\郭有根-第十一章作业_20220721135609.md", "Markdown", -58, 0, -1, -59
"f:\data\learn\javaLearn\note\.history\郭有根-第十一章作业_20220721135746.md", "Markdown", -58, 0, -3, -61
"f:\data\learn\javaLearn\note\.history\郭有根-第十一章作业_20220721140107.md", "Markdown", -58, 0, -6, -64
"f:\data\learn\javaLearn\note\.history\郭有根-第十一章作业_20220721140132.md", "Markdown", -15, 0, -7, -22
"f:\data\learn\javaLearn\note\.history\郭有根-第十一章作业_20220721140233.md", "Markdown", -15, 0, -10, -25
"f:\data\learn\javaLearn\note\.history\郭有根-第十一章作业_20220721140441.md", "Markdown", -40, 0, -12, -52
"f:\data\learn\javaLearn\note\.history\郭有根-第十一章作业_20220721140556.md", "Markdown", -41, 0, -14, -55
"f:\data\learn\javaLearn\note\.history\郭有根-第十一章作业_20220721141002.md", "Markdown", -43, 0, -15, -58
"f:\data\learn\javaLearn\note\.history\郭有根-第十一章作业_20220721141056.md", "Markdown", -43, 0, -15, -58
"f:\data\learn\javaLearn\note\.history\郭有根-第十一章作业_20220721141145.md", "Markdown", -44, 0, -15, -59
"f:\data\learn\javaLearn\note\.history\郭有根-第十一章作业_20220721141153.md", "Markdown", -44, 0, -15, -59
"f:\data\learn\javaLearn\note\.history\郭有根-第十一章作业_20220721141332.md", "Markdown", -44, 0, -15, -59
"f:\data\learn\javaLearn\note\.history\郭有根-第十一章作业_20220721141502.md", "Markdown", -43, 0, -14, -57
"f:\data\learn\javaLearn\note\.history\郭有根-第十一章作业_20220721141749.md", "Markdown", -43, 0, -14, -57
"f:\data\learn\javaLearn\note\.history\郭有根-第十一章作业_20220721141816.md", "Markdown", -44, 0, -15, -59
"f:\data\learn\javaLearn\note\.history\郭有根-第十一章作业_20220721141830.md", "Markdown", -46, 0, -16, -62
"f:\data\learn\javaLearn\note\.history\郭有根-第十一章作业_20220721141855.md", "Markdown", -54, 0, -17, -71
"f:\data\learn\javaLearn\note\.history\郭有根-第十一章作业_20220721141918.md", "Markdown", -55, 0, -18, -73
"f:\data\learn\javaLearn\note\.history\郭有根-第十一章作业_20220721141952.md", "Markdown", -60, 0, -19, -79
"f:\data\learn\javaLearn\note\.history\郭有根-第十一章作业_20220721142021.md", "Markdown", -63, 0, -20, -83
"f:\data\learn\javaLearn\note\.history\郭有根-第十一章作业_20220721142046.md", "Markdown", -68, 0, -20, -88
"f:\data\learn\javaLearn\note\.history\郭有根-第十一章作业_20220721142125.md", "Markdown", -68, 0, -20, -88
"f:\data\learn\javaLearn\note\.history\郭有根-第十一章作业_20220721142130.md", "Markdown", -68, 0, -21, -89
"f:\data\learn\javaLearn\note\.history\郭有根-第十一章作业_20220721145834.md", "Markdown", -68, 0, -21, -89
"f:\data\learn\javaLearn\note\.history\郭有根-第十一章作业_20220721145835.md", "Markdown", -74, 0, -21, -95
"f:\data\learn\javaLearn\note\.history\郭有根-第十一章作业_20220721150010.md", "Markdown", -62, 0, -21, -83
"f:\data\learn\javaLearn\note\.history\郭有根-第十一章作业_20220721150130.md", "Markdown", -68, 0, -21, -89
"f:\data\learn\javaLearn\note\.history\郭有根-第十一章作业_20220721150146.md", "Markdown", -68, 0, -22, -90
"f:\data\learn\javaLearn\note\.history\郭有根-第十一章作业_20220721171637.md", "Markdown", -70, 0, -25, -95
"f:\data\learn\javaLearn\note\.history\郭有根-第十一章作业_20220721171754.md", "Markdown", -70, 0, -23, -93
"f:\data\learn\javaLearn\note\.history\郭有根-第十一章作业_20220722091216.md", "Markdown", -70, 0, -23, -93
"f:\data\learn\javaLearn\note\.history\郭有根-第十一章作业_20220722092550.md", "Markdown", -70, 0, -23, -93
"f:\data\learn\javaLearn\note\.history\郭有根-第十一章作业_20220722101351.md", "Markdown", -70, 0, -23, -93
"f:\data\learn\javaLearn\note\.history\郭有根-第十一章作业_20220722102504.md", "Markdown", -71, 0, -23, -94
"f:\data\learn\javaLearn\note\.history\郭有根-第十一章作业_20220722102525.md", "Markdown", -71, 0, -24, -95
"f:\data\learn\javaLearn\note\.history\郭有根-第十一章作业_20220722102602.md", "Markdown", -83, 0, -25, -108
"f:\data\learn\javaLearn\note\.history\郭有根-第十一章作业_20220722102626.md", "Markdown", -70, 0, -24, -94
"f:\data\learn\javaLearn\note\.history\郭有根-第十一章作业_20220722105119.md", "Markdown", -70, 0, -24, -94
"f:\data\learn\javaLearn\note\.history\郭有根-第十一章作业_20220722115747.md", "Markdown", -70, 0, -24, -94
"f:\data\learn\javaLearn\note\.history\郭有根-第十一章作业_20220722131904.md", "Markdown", -75, 0, -27, -102
"f:\data\learn\javaLearn\note\.history\郭有根-第十一章作业_20220722132932.md", "Markdown", -80, 0, -27, -107
"f:\data\learn\javaLearn\note\.history\郭有根-第十一章作业_20220722133831.md", "Markdown", -81, 0, -27, -108
"f:\data\learn\javaLearn\note\.history\郭有根-第十一章作业_20220722141401.md", "Markdown", -74, 0, -26, -100
"f:\data\learn\javaLearn\note\.history\郭有根-第十一章作业_20220722161754.md", "Markdown", -75, 0, -25, -100
"f:\data\learn\javaLearn\note\.history\郭有根-第十一章作业_20220722162026.md", "Markdown", -77, 0, -26, -103
"f:\data\learn\javaLearn\note\.history\郭有根-第十一章作业_20220722162106.md", "Markdown", -80, 0, -28, -108
"f:\data\learn\javaLearn\note\.history\郭有根-第十一章作业_20220722162309.md", "Markdown", -136, 0, -40, -176
"f:\data\learn\javaLearn\note\.history\郭有根-第十一章作业_20220722162749.md", "Markdown", -200, 0, -44, -244
"f:\data\learn\javaLearn\note\.history\郭有根-第十一章作业_20220722162812.md", "Markdown", -201, 0, -46, -247
"f:\data\learn\javaLearn\note\.history\郭有根-第十一章作业_20220722162853.md", "Markdown", -227, 0, -47, -274
"f:\data\learn\javaLearn\note\.history\郭有根-第十一章作业_20220722162914.md", "Markdown", -227, 0, -49, -276
"f:\data\learn\javaLearn\note\.history\郭有根-第十一章作业_20220722163011.md", "Markdown", -228, 0, -48, -276
"f:\data\learn\javaLearn\note\.history\郭有根-第十一章作业_20220722163139.md", "Markdown", -228, 0, -48, -276
"f:\data\learn\javaLearn\note\.history\郭有根-第十一章作业_20220722163348.md", "Markdown", -228, 0, -48, -276
"f:\data\learn\javaLearn\note\.history\郭有根-第十一章作业_20220722163403.md", "Markdown", -228, 0, -48, -276
"f:\data\learn\javaLearn\note\.history\郭有根-第十一章作业_20220722163443.md", "Markdown", -228, 0, -48, -276
"f:\data\learn\javaLearn\note\.history\郭有根-第十一章作业_20220722163728.md", "Markdown", -228, 0, -48, -276
"f:\data\learn\javaLearn\note\.history\郭有根-第十一章作业_20220722164022.md", "Markdown", -228, 0, -48, -276
"f:\data\learn\javaLearn\note\.history\郭有根-第十一章作业_20220722164049.md", "Markdown", -228, 0, -48, -276
"f:\data\learn\javaLearn\note\.history\郭有根-第十一章作业_20220722164124.md", "Markdown", -228, 0, -48, -276
"f:\data\learn\javaLearn\note\.history\郭有根-第十一章作业_20220722164156.md", "Markdown", -228, 0, -48, -276
"f:\data\learn\javaLearn\note\.history\郭有根-第十一章作业_20220722164217.md", "Markdown", -228, 0, -48, -276
"f:\data\learn\javaLearn\note\.history\郭有根-第十一章作业_20220722164259.md", "Markdown", -228, 0, -48, -276
"f:\data\learn\javaLearn\note\.history\郭有根-第十一章作业_20220722164304.md", "Markdown", -228, 0, -47, -275
"f:\data\learn\javaLearn\note\.history\郭有根-第十一章作业_20220722164438.md", "Markdown", -228, 0, -47, -275
"f:\data\learn\javaLearn\note\.history\郭有根-第十七章作业_20220802130604.md", "Markdown", 0, 0, -1, -1
"f:\data\learn\javaLearn\note\.history\郭有根-第十七章作业_20220802130605.md", "Markdown", -6, 0, -1, -7
"f:\data\learn\javaLearn\note\.history\郭有根-第十七章作业_20220802130657.md", "Markdown", -11, 0, -6, -17
"f:\data\learn\javaLearn\note\.history\郭有根-第十七章作业_20220802130725.md", "Markdown", -13, 0, -5, -18
"f:\data\learn\javaLearn\note\.history\郭有根-第十七章作业_20220802130732.md", "Markdown", -14, 0, -5, -19
"f:\data\learn\javaLearn\note\.history\郭有根-第十七章作业_20220802130803.md", "Markdown", -15, 0, -5, -20
"f:\data\learn\javaLearn\note\.history\郭有根-第十七章作业_20220802131425.md", "Markdown", -15, 0, -5, -20
"f:\data\learn\javaLearn\note\.history\郭有根-第十七章作业_20220802131435.md", "Markdown", -15, 0, -7, -22
"f:\data\learn\javaLearn\note\.history\郭有根-第十七章作业_20220802132736.md", "Markdown", -16, 0, -9, -25
"f:\data\learn\javaLearn\note\.history\郭有根-第十七章作业_20220802132926.md", "Markdown", -19, 0, -11, -30
"f:\data\learn\javaLearn\note\.history\郭有根-第十七章作业_20220802133513.md", "Markdown", -19, 0, -13, -32
"f:\data\learn\javaLearn\note\.history\郭有根-第十七章作业_20220802134105.md", "Markdown", -21, 0, -12, -33
"f:\data\learn\javaLearn\note\.history\郭有根-第十七章作业_20220802134233.md", "Markdown", -21, 0, -12, -33
"f:\data\learn\javaLearn\note\.history\郭有根-第十七章作业_20220802134521.md", "Markdown", -24, 0, -11, -35
"f:\data\learn\javaLearn\note\.history\郭有根-第十七章作业_20220802135353.md", "Markdown", -26, 0, -12, -38
"f:\data\learn\javaLearn\note\.history\郭有根-第十七章作业_20220802135447.md", "Markdown", -26, 0, -13, -39
"f:\data\learn\javaLearn\note\.history\郭有根-第十七章作业_20220802140005.md", "Markdown", -27, 0, -15, -42
"f:\data\learn\javaLearn\note\.history\郭有根-第十七章作业_20220802140114.md", "Markdown", -50, 0, -20, -70
"f:\data\learn\javaLearn\note\.history\郭有根-第十七章作业_20220802140200.md", "Markdown", -52, 0, -23, -75
"f:\data\learn\javaLearn\note\.history\郭有根-第十七章作业_20220802140245.md", "Markdown", -81, 0, -27, -108
"f:\data\learn\javaLearn\note\.history\郭有根-第十七章作业_20220802140319.md", "Markdown", -83, 0, -30, -113
"f:\data\learn\javaLearn\note\.history\郭有根-第十七章作业_20220802140327.md", "Markdown", -83, 0, -30, -113
"f:\data\learn\javaLearn\note\.history\郭有根-第十七章作业_20220802140341.md", "Markdown", -84, 0, -30, -114
"f:\data\learn\javaLearn\note\.history\郭有根-第十七章作业_20220802140442.md", "Markdown", -134, 0, -42, -176
"f:\data\learn\javaLearn\note\.history\郭有根-第十七章作业_20220802140545.md", "Markdown", -137, 0, -46, -183
"f:\data\learn\javaLearn\note\.history\郭有根-第十七章作业_20220802140624.md", "Markdown", -182, 0, -57, -239
"f:\data\learn\javaLearn\note\.history\郭有根-第十七章作业_20220802140914.md", "Markdown", -220, 0, -59, -279
"f:\data\learn\javaLearn\note\.history\郭有根-第十七章作业_20220802141119.md", "Markdown", -309, 0, -71, -380
"f:\data\learn\javaLearn\note\.history\郭有根-第十七章作业_20220802141142.md", "Markdown", -311, 0, -74, -385
"f:\data\learn\javaLearn\note\.history\郭有根-第十七章作业_20220802141218.md", "Markdown", -334, 0, -79, -413
"f:\data\learn\javaLearn\note\.history\郭有根-第十七章作业_20220802141305.md", "Markdown", -335, 0, -78, -413
"f:\data\learn\javaLearn\note\.history\郭有根-第十七章作业_20220802141324.md", "Markdown", -336, 0, -77, -413
"f:\data\learn\javaLearn\note\.history\郭有根-第十七章作业_20220802141339.md", "Markdown", -338, 0, -78, -416
"f:\data\learn\javaLearn\note\.history\郭有根-第十七章作业_20220802141353.md", "Markdown", -338, 0, -79, -417
"f:\data\learn\javaLearn\note\.history\郭有根-第十七章作业_20220802141457.md", "Markdown", -372, 0, -87, -459
"f:\data\learn\javaLearn\note\.history\郭有根-第十七章作业_20220802141540.md", "Markdown", -374, 0, -90, -464
"f:\data\learn\javaLearn\note\.history\郭有根-第十七章作业_20220802141618.md", "Markdown", -391, 0, -91, -482
"f:\data\learn\javaLearn\note\.history\郭有根-第十七章作业_20220802141652.md", "Markdown", -392, 0, -92, -484
"f:\data\learn\javaLearn\note\.history\郭有根-第十七章作业_20220802141657.md", "Markdown", -392, 0, -92, -484
"f:\data\learn\javaLearn\note\.history\郭有根-第十七章作业_20220802141730.md", "Markdown", -393, 0, -94, -487
"f:\data\learn\javaLearn\note\.history\郭有根-第十七章作业_20220802141759.md", "Markdown", -497, 0, -102, -599
"f:\data\learn\javaLearn\note\.history\郭有根-第十七章作业_20220802141932.md", "Markdown", -499, 0, -105, -604
"f:\data\learn\javaLearn\note\.history\郭有根-第十七章作业_20220802142013.md", "Markdown", -525, 0, -111, -636
"f:\data\learn\javaLearn\note\.history\郭有根-第十七章作业_20220802142835.md", "Markdown", -526, 0, -111, -637
"f:\data\learn\javaLearn\note\.history\郭有根-第十七章作业_20220802143131.md", "Markdown", -526, 0, -111, -637
"f:\data\learn\javaLearn\note\.history\郭有根-第十七章作业_20220802143536.md", "Markdown", -526, 0, -111, -637
"f:\data\learn\javaLearn\note\.history\郭有根-第十七章作业_20220802143604.md", "Markdown", -526, 0, -111, -637
"f:\data\learn\javaLearn\note\.history\郭有根-第十三章作业_20220725100125.md", "Markdown", 0, 0, -1, -1
"f:\data\learn\javaLearn\note\.history\郭有根-第十三章作业_20220725100127.md", "Markdown", -6, 0, -1, -7
"f:\data\learn\javaLearn\note\.history\郭有根-第十三章作业_20220725100135.md", "Markdown", -11, 0, -4, -15
"f:\data\learn\javaLearn\note\.history\郭有根-第十三章作业_20220725100215.md", "Markdown", -11, 0, -5, -16
"f:\data\learn\javaLearn\note\.history\郭有根-第十三章作业_20220725100303.md", "Markdown", -12, 0, -6, -18
"f:\data\learn\javaLearn\note\.history\郭有根-第十三章作业_20220725100314.md", "Markdown", -13, 0, -7, -20
"f:\data\learn\javaLearn\note\.history\郭有根-第十三章作业_20220725100324.md", "Markdown", -14, 0, -8, -22
"f:\data\learn\javaLearn\note\.history\郭有根-第十三章作业_20220725100348.md", "Markdown", -15, 0, -9, -24
"f:\data\learn\javaLearn\note\.history\郭有根-第十三章作业_20220725100358.md", "Markdown", -16, 0, -10, -26
"f:\data\learn\javaLearn\note\.history\郭有根-第十三章作业_20220725100422.md", "Markdown", -17, 0, -11, -28
"f:\data\learn\javaLearn\note\.history\郭有根-第十三章作业_20220725100430.md", "Markdown", -18, 0, -11, -29
"f:\data\learn\javaLearn\note\.history\郭有根-第十三章作业_20220725100622.md", "Markdown", -20, 0, -11, -31
"f:\data\learn\javaLearn\note\.history\郭有根-第十三章作业_20220725100641.md", "Markdown", -21, 0, -11, -32
"f:\data\learn\javaLearn\note\.history\郭有根-第十三章作业_20220725100708.md", "Markdown", -25, 0, -12, -37
"f:\data\learn\javaLearn\note\.history\郭有根-第十三章作业_20220725100733.md", "Markdown", -43, 0, -12, -55
"f:\data\learn\javaLearn\note\.history\郭有根-第十三章作业_20220725100750.md", "Markdown", -45, 0, -14, -59
"f:\data\learn\javaLearn\note\.history\郭有根-第十三章作业_20220725100802.md", "Markdown", -46, 0, -15, -61
"f:\data\learn\javaLearn\note\.history\郭有根-第十三章作业_20220725100919.md", "Markdown", -49, 0, -15, -64
"f:\data\learn\javaLearn\note\.history\郭有根-第十三章作业_20220725101152.md", "Markdown", -93, 0, -18, -111
"f:\data\learn\javaLearn\note\.history\郭有根-第十三章作业_20220725101446.md", "Markdown", -95, 0, -18, -113
"f:\data\learn\javaLearn\note\.history\郭有根-第十三章作业_20220725101515.md", "Markdown", -94, 0, -21, -115
"f:\data\learn\javaLearn\note\.history\郭有根-第十三章作业_20220725101609.md", "Markdown", -94, 0, -23, -117
"f:\data\learn\javaLearn\note\.history\郭有根-第十三章作业_20220725101637.md", "Markdown", -104, 0, -22, -126
"f:\data\learn\javaLearn\note\.history\郭有根-第十三章作业_20220725101718.md", "Markdown", -107, 0, -23, -130
"f:\data\learn\javaLearn\note\.history\郭有根-第十三章作业_20220725101846.md", "Markdown", -108, 0, -26, -134
"f:\data\learn\javaLearn\note\.history\郭有根-第十三章作业_20220725172942.md", "Markdown", -108, 0, -26, -134
"f:\data\learn\javaLearn\note\.history\郭有根-第十三章作业_20220726024433.md", "Markdown", -108, 0, -26, -134
"f:\data\learn\javaLearn\note\.history\郭有根-第十三章作业_20220726094140.md", "Markdown", -110, 0, -27, -137
"f:\data\learn\javaLearn\note\.history\郭有根-第十三章作业_20220726094344.md", "Markdown", -110, 0, -27, -137
"f:\data\learn\javaLearn\note\.history\郭有根-第十三章作业_20220726094605.md", "Markdown", -110, 0, -27, -137
"f:\data\learn\javaLearn\note\.history\郭有根-第十三章作业_20220726094641.md", "Markdown", -110, 0, -27, -137
"f:\data\learn\javaLearn\note\.history\郭有根-第十三章作业_20220726094653.md", "Markdown", -110, 0, -27, -137
"f:\data\learn\javaLearn\note\.history\郭有根-第十三章作业_20220726094739.md", "Markdown", -111, 0, -27, -138
"f:\data\learn\javaLearn\note\.history\郭有根-第十三章作业_20220726094825.md", "Markdown", -112, 0, -27, -139
"f:\data\learn\javaLearn\note\.history\郭有根-第十三章作业_20220726095129.md", "Markdown", -113, 0, -28, -141
"f:\data\learn\javaLearn\note\.history\郭有根-第十三章作业_20220726095657.md", "Markdown", -115, 0, -28, -143
"f:\data\learn\javaLearn\note\.history\郭有根-第十三章作业_20220726095826.md", "Markdown", -117, 0, -30, -147
"f:\data\learn\javaLearn\note\.history\郭有根-第十三章作业_20220726100126.md", "Markdown", -120, 0, -33, -153
"f:\data\learn\javaLearn\note\.history\郭有根-第十三章作业_20220726100149.md", "Markdown", -267, 0, -39, -306
"f:\data\learn\javaLearn\note\.history\郭有根-第十三章作业_20220726100331.md", "Markdown", -269, 0, -41, -310
"f:\data\learn\javaLearn\note\.history\郭有根-第十三章作业_20220726100358.md", "Markdown", -291, 0, -45, -336
"f:\data\learn\javaLearn\note\.history\郭有根-第十三章作业_20220726100500.md", "Markdown", -292, 0, -45, -337
"f:\data\learn\javaLearn\note\.history\郭有根-第十三章作业_20220726100548.md", "Markdown", -293, 0, -45, -338
"f:\data\learn\javaLearn\note\.history\郭有根-第十三章作业_20220726100725.md", "Markdown", -294, 0, -43, -337
"f:\data\learn\javaLearn\note\.history\郭有根-第十三章作业_20220726101422.md", "Markdown", -297, 0, -45, -342
"f:\data\learn\javaLearn\note\.history\郭有根-第十三章作业_20220726101517.md", "Markdown", -393, 0, -51, -444
"f:\data\learn\javaLearn\note\.history\郭有根-第十三章作业_20220726101531.md", "Markdown", -410, 0, -52, -462
"f:\data\learn\javaLearn\note\.history\郭有根-第十三章作业_20220726101558.md", "Markdown", -410, 0, -54, -464
"f:\data\learn\javaLearn\note\.history\郭有根-第十三章作业_20220726101722.md", "Markdown", -411, 0, -54, -465
"f:\data\learn\javaLearn\note\.history\郭有根-第十三章作业_20220726101835.md", "Markdown", -413, 0, -53, -466
"f:\data\learn\javaLearn\note\.history\郭有根-第十三章作业_20220726101842.md", "Markdown", -413, 0, -53, -466
"f:\data\learn\javaLearn\note\.history\郭有根-第十三章作业_20220726101857.md", "Markdown", -413, 0, -53, -466
"f:\data\learn\javaLearn\note\.history\郭有根-第十三章作业_20220726102043.md", "Markdown", -413, 0, -53, -466
"f:\data\learn\javaLearn\note\.history\郭有根-第十三章作业_20220726102120.md", "Markdown", -413, 0, -55, -468
"f:\data\learn\javaLearn\note\.history\郭有根-第十三章作业_20220726102203.md", "Markdown", -414, 0, -54, -468
"f:\data\learn\javaLearn\note\.history\郭有根-第十三章作业_20220726102319.md", "Markdown", -415, 0, -54, -469
"f:\data\learn\javaLearn\note\.history\郭有根-第十三章作业_20220726102330.md", "Markdown", -415, 0, -54, -469
"f:\data\learn\javaLearn\note\.history\郭有根-第十三章作业_20220726102444.md", "Markdown", -415, 0, -54, -469
"f:\data\learn\javaLearn\note\.history\郭有根-第十三章作业_20220726102445.md", "Markdown", -415, 0, -54, -469
"f:\data\learn\javaLearn\note\.history\郭有根-第十三章作业_20220726102446.md", "Markdown", -415, 0, -54, -469
"f:\data\learn\javaLearn\note\.history\郭有根-第十三章作业_20220726102447.md", "Markdown", -415, 0, -54, -469
"f:\data\learn\javaLearn\note\.history\郭有根-第十三章作业_20220726102448.md", "Markdown", -415, 0, -54, -469
"f:\data\learn\javaLearn\note\.history\郭有根-第十三章作业_20220726104543.md", "Markdown", -361, 0, -52, -413
"f:\data\learn\javaLearn\note\.history\郭有根-第十三章作业_20220726104614.md", "Markdown", -415, 0, -54, -469
"f:\data\learn\javaLearn\note\.history\郭有根-第十三章作业_20220726104714.md", "Markdown", -306, 0, -50, -356
"f:\data\learn\javaLearn\note\.history\郭有根-第十三章作业_20220726104745.md", "Markdown", -398, 0, -54, -452
"f:\data\learn\javaLearn\note\.history\郭有根-第十三章作业_20220726104800.md", "Markdown", -416, 0, -56, -472
"f:\data\learn\javaLearn\note\.history\郭有根-第十三章作业_20220726104906.md", "Markdown", -416, 0, -56, -472
"f:\data\learn\javaLearn\note\.history\郭有根-第十三章作业_20220726104907.md", "Markdown", -416, 0, -56, -472
"f:\data\learn\javaLearn\note\.history\郭有根-第十三章作业_20220726105107.md", "Markdown", -416, 0, -56, -472
"f:\data\learn\javaLearn\note\.history\郭有根-第十三章作业_20220726170153.md", "Markdown", -411, 0, -62, -473
"f:\data\learn\javaLearn\note\.history\郭有根-第十三章作业_20220726170159.md", "Markdown", -411, 0, -62, -473
"f:\data\learn\javaLearn\note\.history\郭有根-第十三章作业_20220726170207.md", "Markdown", -411, 0, -62, -473
"f:\data\learn\javaLearn\note\.history\郭有根-第十三章作业_20220726170212.md", "Markdown", -411, 0, -62, -473
"f:\data\learn\javaLearn\note\.history\郭有根-第十三章作业_20220726170434.md", "Markdown", -411, 0, -62, -473
"f:\data\learn\javaLearn\note\.history\郭有根-第十三章作业_20220726170437.md", "Markdown", -411, 0, -62, -473
"f:\data\learn\javaLearn\note\.history\郭有根-第十九次作业_20220805165508.md", "Markdown", 0, 0, -1, -1
"f:\data\learn\javaLearn\note\.history\郭有根-第十九次作业_20220805165517.md", "Markdown", -4, 0, -2, -6
"f:\data\learn\javaLearn\note\.history\郭有根-第十九次作业_20220805165518.md", "Markdown", -10, 0, -2, -12
"f:\data\learn\javaLearn\note\.history\郭有根-第十九次作业_20220805165541.md", "Markdown", -10, 0, -4, -14
"f:\data\learn\javaLearn\note\.history\郭有根-第十九次作业_20220805165646.md", "Markdown", -11, 0, -6, -17
"f:\data\learn\javaLearn\note\.history\郭有根-第十九次作业_20220805165720.md", "Markdown", -14, 0, -8, -22
"f:\data\learn\javaLearn\note\.history\郭有根-第十九次作业_20220805165741.md", "Markdown", -15, 0, -10, -25
"f:\data\learn\javaLearn\note\.history\郭有根-第十九次作业_20220805165842.md", "Markdown", -17, 0, -9, -26
"f:\data\learn\javaLearn\note\.history\郭有根-第十九次作业_20220805165850.md", "Markdown", -17, 0, -9, -26
"f:\data\learn\javaLearn\note\.history\郭有根-第十九次作业_20220805170056.md", "Markdown", -18, 0, -12, -30
"f:\data\learn\javaLearn\note\.history\郭有根-第十九次作业_20220805170134.md", "Markdown", -19, 0, -12, -31
"f:\data\learn\javaLearn\note\.history\郭有根-第十九次作业_20220805170141.md", "Markdown", -19, 0, -12, -31
"f:\data\learn\javaLearn\note\.history\郭有根-第十九次作业_20220805170204.md", "Markdown", -20, 0, -15, -35
"f:\data\learn\javaLearn\note\.history\郭有根-第十九次作业_20220805170234.md", "Markdown", -35, 0, -17, -52
"f:\data\learn\javaLearn\note\.history\郭有根-第十九次作业_20220805170241.md", "Markdown", -35, 0, -17, -52
"f:\data\learn\javaLearn\note\.history\郭有根-第十九次作业_20220805170305.md", "Markdown", -36, 0, -19, -55
"f:\data\learn\javaLearn\note\.history\郭有根-第十九次作业_20220805170324.md", "Markdown", -47, 0, -21, -68
"f:\data\learn\javaLearn\note\.history\郭有根-第十九次作业_20220805170400.md", "Markdown", -47, 0, -21, -68
"f:\data\learn\javaLearn\note\.history\郭有根-第十九次作业_20220805170432.md", "Markdown", -47, 0, -23, -70
"f:\data\learn\javaLearn\note\.history\郭有根-第十九次作业_20220805170459.md", "Markdown", -72, 0, -29, -101
"f:\data\learn\javaLearn\note\.history\郭有根-第十九次作业_20220805170514.md", "Markdown", -73, 0, -30, -103
"f:\data\learn\javaLearn\note\.history\郭有根-第十九次作业_20220805170525.md", "Markdown", -74, 0, -30, -104
"f:\data\learn\javaLearn\note\.history\郭有根-第十九次作业_20220805170542.md", "Markdown", -107, 0, -36, -143
"f:\data\learn\javaLearn\note\.history\郭有根-第十九次作业_20220805170557.md", "Markdown", -108, 0, -35, -143
"f:\data\learn\javaLearn\note\.history\郭有根-第十九次作业_20220805170957.md", "Markdown", -109, 0, -34, -143
"f:\data\learn\javaLearn\note\.history\郭有根-第十九次作业_20220805171021.md", "Markdown", -110, 0, -36, -146
"f:\data\learn\javaLearn\note\.history\郭有根-第十九次作业_20220805171110.md", "Markdown", -112, 0, -37, -149
"f:\data\learn\javaLearn\note\.history\郭有根-第十九次作业_20220805171310.md", "Markdown", -140, 0, -42, -182
"f:\data\learn\javaLearn\note\.history\郭有根-第十九次作业_20220805171334.md", "Markdown", -141, 0, -43, -184
"f:\data\learn\javaLearn\note\.history\郭有根-第十九次作业_20220805171422.md", "Markdown", -141, 0, -45, -186
"f:\data\learn\javaLearn\note\.history\郭有根-第十九次作业_20220805171526.md", "Markdown", -143, 0, -45, -188
"f:\data\learn\javaLearn\note\.history\郭有根-第十九次作业_20220805171549.md", "Markdown", -145, 0, -48, -193
"f:\data\learn\javaLearn\note\.history\郭有根-第十九次作业_20220805171623.md", "Markdown", -180, 0, -52, -232
"f:\data\learn\javaLearn\note\.history\郭有根-第十九次作业_20220805171815.md", "Markdown", -183, 0, -55, -238
"f:\data\learn\javaLearn\note\.history\郭有根-第十九次作业_20220805171843.md", "Markdown", -184, 0, -57, -241
"f:\data\learn\javaLearn\note\.history\郭有根-第十九次作业_20220805171919.md", "Markdown", -192, 0, -58, -250
"f:\data\learn\javaLearn\note\.history\郭有根-第十九次作业_20220805172024.md", "Markdown", -200, 0, -59, -259
"f:\data\learn\javaLearn\note\.history\郭有根-第十九次作业_20220805172130.md", "Markdown", -268, 0, -76, -344
"f:\data\learn\javaLearn\note\.history\郭有根-第十九次作业_20220805172220.md", "Markdown", -318, 0, -83, -401
"f:\data\learn\javaLearn\note\.history\郭有根-第十九次作业_20220805172358.md", "Markdown", -319, 0, -83, -402
"f:\data\learn\javaLearn\note\.history\郭有根-第十九次作业_20220805192855.md", "Markdown", -319, 0, -83, -402
"f:\data\learn\javaLearn\note\.history\郭有根-第十九次作业_20220807010054.md", "Markdown", -319, 0, -83, -402
"f:\data\learn\javaLearn\note\.history\郭有根-第十二章作业_20220722164827.md", "Markdown", 0, 0, -1, -1
"f:\data\learn\javaLearn\note\.history\郭有根-第十二章作业_20220722164828.md", "Markdown", -6, 0, -1, -7
"f:\data\learn\javaLearn\note\.history\郭有根-第十二章作业_20220722164902.md", "Markdown", -10, 0, -4, -14
"f:\data\learn\javaLearn\note\.history\郭有根-第十二章作业_20220722164930.md", "Markdown", -11, 0, -4, -15
"f:\data\learn\javaLearn\note\.history\郭有根-第十二章作业_20220722164946.md", "Markdown", -13, 0, -5, -18
"f:\data\learn\javaLearn\note\.history\郭有根-第十二章作业_20220722165029.md", "Markdown", -15, 0, -7, -22
"f:\data\learn\javaLearn\note\.history\郭有根-第十二章作业_20220722165412.md", "Markdown", -51, 0, -12, -63
"f:\data\learn\javaLearn\note\.history\郭有根-第十二章作业_20220722165737.md", "Markdown", -55, 0, -13, -68
"f:\data\learn\javaLearn\note\.history\郭有根-第十二章作业_20220722170437.md", "Markdown", -55, 0, -14, -69
"f:\data\learn\javaLearn\note\.history\郭有根-第十二章作业_20220723165459.md", "Markdown", -55, 0, -16, -71
"f:\data\learn\javaLearn\note\.history\郭有根-第十二章作业_20220725010208.md", "Markdown", -56, 0, -15, -71
"f:\data\learn\javaLearn\note\.history\郭有根-第十二章作业_20220725010229.md", "Markdown", -56, 0, -15, -71
"f:\data\learn\javaLearn\note\.history\郭有根-第十二章作业_20220725010347.md", "Markdown", -57, 0, -15, -72
"f:\data\learn\javaLearn\note\.history\郭有根-第十二章作业_20220725010836.md", "Markdown", -61, 0, -21, -82
"f:\data\learn\javaLearn\note\.history\郭有根-第十二章作业_20220725011014.md", "Markdown", -61, 0, -21, -82
"f:\data\learn\javaLearn\note\.history\郭有根-第十二章作业_20220725011145.md", "Markdown", -63, 0, -24, -87
"f:\data\learn\javaLearn\note\.history\郭有根-第十二章作业_20220725011517.md", "Markdown", -223, 0, -31, -254
"f:\data\learn\javaLearn\note\.history\郭有根-第十二章作业_20220725011629.md", "Markdown", -252, 0, -34, -286
"f:\data\learn\javaLearn\note\.history\郭有根-第十二章作业_20220725012024.md", "Markdown", -253, 0, -35, -288
"f:\data\learn\javaLearn\note\.history\郭有根-第十二章作业_20220725012035.md", "Markdown", -254, 0, -35, -289
"f:\data\learn\javaLearn\note\.history\郭有根-第十二章作业_20220725012246.md", "Markdown", -254, 0, -35, -289
"f:\data\learn\javaLearn\note\.history\郭有根-第十二章作业_20220725012553.md", "Markdown", -254, 0, -33, -287
"f:\data\learn\javaLearn\note\.history\郭有根-第十二章作业_20220725012834.md", "Markdown", -255, 0, -34, -289
"f:\data\learn\javaLearn\note\.history\郭有根-第十二章作业_20220725012856.md", "Markdown", -255, 0, -34, -289
"f:\data\learn\javaLearn\note\.history\郭有根-第十二章作业_20220725013052.md", "Markdown", -255, 0, -34, -289
"f:\data\learn\javaLearn\note\.history\郭有根-第十二章作业_20220725013207.md", "Markdown", -255, 0, -34, -289
"f:\data\learn\javaLearn\note\.history\郭有根-第十二章作业_20220725013536.md", "Markdown", -255, 0, -34, -289
"f:\data\learn\javaLearn\note\.history\郭有根-第十二章作业_20220725013630.md", "Markdown", -255, 0, -34, -289
"f:\data\learn\javaLearn\note\.history\郭有根-第十二章作业_20220725013832.md", "Markdown", -255, 0, -34, -289
"f:\data\learn\javaLearn\note\.history\郭有根-第十二章作业_20220725014021.md", "Markdown", -255, 0, -34, -289
"f:\data\learn\javaLearn\note\.history\郭有根-第十二章作业_20220725014502.md", "Markdown", -255, 0, -34, -289
"f:\data\learn\javaLearn\note\.history\郭有根-第十二章作业_20220725014628.md", "Markdown", -255, 0, -36, -291
"f:\data\learn\javaLearn\note\.history\郭有根-第十二章作业_20220725014735.md", "Markdown", -256, 0, -35, -291
"f:\data\learn\javaLearn\note\.history\郭有根-第十二章作业_20220725014831.md", "Markdown", -256, 0, -35, -291
"f:\data\learn\javaLearn\note\.history\郭有根-第十二章作业_20220725014959.md", "Markdown", -257, 0, -35, -292
"f:\data\learn\javaLearn\note\.history\郭有根-第十二章作业_20220725015036.md", "Markdown", -257, 0, -35, -292
"f:\data\learn\javaLearn\note\.history\郭有根-第十二章作业_20220725015047.md", "Markdown", -257, 0, -35, -292
"f:\data\learn\javaLearn\note\.history\郭有根-第十二章作业_20220725015048.md", "Markdown", -257, 0, -35, -292
"f:\data\learn\javaLearn\note\.history\郭有根-第十二章作业_20220725015054.md", "Markdown", -257, 0, -35, -292
"f:\data\learn\javaLearn\note\.history\郭有根-第十二章作业_20220725084527.md", "Markdown", -257, 0, -36, -293
"f:\data\learn\javaLearn\note\.history\郭有根-第十二章作业_20220725094708.md", "Markdown", -257, 0, -36, -293
"f:\data\learn\javaLearn\note\.history\郭有根-第十二章作业_20220725095253.md", "Markdown", -256, 0, -35, -291
"f:\data\learn\javaLearn\note\.history\郭有根-第十二章作业_20220725095900.md", "Markdown", -257, 0, -34, -291
"f:\data\learn\javaLearn\note\.history\郭有根-第十二章作业_20220725095921.md", "Markdown", -257, 0, -34, -291
"f:\data\learn\javaLearn\note\.history\郭有根-第十二章作业_20220725100007.md", "Markdown", -256, 0, -35, -291
"f:\data\learn\javaLearn\note\.history\郭有根-第十五章作业_20220728100244.md", "Markdown", 0, 0, -1, -1
"f:\data\learn\javaLearn\note\.history\郭有根-第十五章作业_20220728100246.md", "Markdown", -6, 0, -1, -7
"f:\data\learn\javaLearn\note\.history\郭有根-第十五章作业_20220728100258.md", "Markdown", -10, 0, -2, -12
"f:\data\learn\javaLearn\note\.history\郭有根-第十五章作业_20220728100339.md", "Markdown", -10, 0, -4, -14
"f:\data\learn\javaLearn\note\.history\郭有根-第十五章作业_20220728100417.md", "Markdown", -12, 0, -5, -17
"f:\data\learn\javaLearn\note\.history\郭有根-第十五章作业_20220728100442.md", "Markdown", -13, 0, -6, -19
"f:\data\learn\javaLearn\note\.history\郭有根-第十五章作业_20220728100459.md", "Markdown", -14, 0, -7, -21
"f:\data\learn\javaLearn\note\.history\郭有根-第十五章作业_20220728100512.md", "Markdown", -14, 0, -9, -23
"f:\data\learn\javaLearn\note\.history\郭有根-第十五章作业_20220728100600.md", "Markdown", -17, 0, -10, -27
"f:\data\learn\javaLearn\note\.history\郭有根-第十五章作业_20220728100713.md", "Markdown", -18, 0, -10, -28
"f:\data\learn\javaLearn\note\.history\郭有根-第十五章作业_20220728101151.md", "Markdown", -18, 0, -13, -31
"f:\data\learn\javaLearn\note\.history\郭有根-第十五章作业_20220728104501.md", "Markdown", -31, 0, -12, -43
"f:\data\learn\javaLearn\note\.history\郭有根-第十五章作业_20220728230030.md", "Markdown", -31, 0, -12, -43
"f:\data\learn\javaLearn\note\.history\郭有根-第十五章作业_20220728230446.md", "Markdown", -31, 0, -12, -43
"f:\data\learn\javaLearn\note\.history\郭有根-第十五章作业_20220728230525.md", "Markdown", -32, 0, -13, -45
"f:\data\learn\javaLearn\note\.history\郭有根-第十五章作业_20220728230603.md", "Markdown", -39, 0, -16, -55
"f:\data\learn\javaLearn\note\.history\郭有根-第十五章作业_20220728230640.md", "Markdown", -48, 0, -17, -65
"f:\data\learn\javaLearn\note\.history\郭有根-第十五章作业_20220728230706.md", "Markdown", -48, 0, -19, -67
"f:\data\learn\javaLearn\note\.history\郭有根-第十五章作业_20220728230741.md", "Markdown", -61, 0, -21, -82
"f:\data\learn\javaLearn\note\.history\郭有根-第十五章作业_20220728230836.md", "Markdown", -62, 0, -22, -84
"f:\data\learn\javaLearn\note\.history\郭有根-第十五章作业_20220728230924.md", "Markdown", -65, 0, -24, -89
"f:\data\learn\javaLearn\note\.history\郭有根-第十五章作业_20220728231020.md", "Markdown", -65, 0, -24, -89
"f:\data\learn\javaLearn\note\.history\郭有根-第十五章作业_20220729011513.md", "Markdown", -65, 0, -24, -89
"f:\data\learn\javaLearn\note\.history\郭有根-第十五章作业_20220729015003.md", "Markdown", -68, 0, -25, -93
"f:\data\learn\javaLearn\note\.history\郭有根-第十五章作业_20220729015102.md", "Markdown", -68, 0, -25, -93
"f:\data\learn\javaLearn\note\.history\郭有根-第十五章作业_20220729015122.md", "Markdown", -68, 0, -25, -93
"f:\data\learn\javaLearn\note\.history\郭有根-第十五章作业_20220729015240.md", "Markdown", -69, 0, -27, -96
"f:\data\learn\javaLearn\note\.history\郭有根-第十五章作业_20220729015420.md", "Markdown", -69, 0, -27, -96
"f:\data\learn\javaLearn\note\.history\郭有根-第十五章作业_20220729015607.md", "Markdown", -115, 0, -32, -147
"f:\data\learn\javaLearn\note\.history\郭有根-第十五章作业_20220729015711.md", "Markdown", -165, 0, -41, -206
"f:\data\learn\javaLearn\note\.history\郭有根-第十五章作业_20220729015957.md", "Markdown", -166, 0, -42, -208
"f:\data\learn\javaLearn\note\.history\郭有根-第十五章作业_20220729020122.md", "Markdown", -166, 0, -42, -208
"f:\data\learn\javaLearn\note\.history\郭有根-第十五章作业_20220729020507.md", "Markdown", -167, 0, -43, -210
"f:\data\learn\javaLearn\note\.history\郭有根-第十五章作业_20220729020546.md", "Markdown", -168, 0, -44, -212
"f:\data\learn\javaLearn\note\.history\郭有根-第十五章作业_20220729020617.md", "Markdown", -169, 0, -43, -212
"f:\data\learn\javaLearn\note\.history\郭有根-第十五章作业_20220729020835.md", "Markdown", -169, 0, -44, -213
"f:\data\learn\javaLearn\note\.history\郭有根-第十五章作业_20220729021111.md", "Markdown", -167, 0, -43, -210
"f:\data\learn\javaLearn\note\.history\郭有根-第十五章作业_20220729021331.md", "Markdown", -172, 0, -45, -217
"f:\data\learn\javaLearn\note\.history\郭有根-第十五章作业_20220729021546.md", "Markdown", -175, 0, -47, -222
"f:\data\learn\javaLearn\note\.history\郭有根-第十五章作业_20220729021627.md", "Markdown", -176, 0, -48, -224
"f:\data\learn\javaLearn\note\.history\郭有根-第十五章作业_20220729022026.md", "Markdown", -181, 0, -49, -230
"f:\data\learn\javaLearn\note\.history\郭有根-第十五章作业_20220729022037.md", "Markdown", -181, 0, -49, -230
"f:\data\learn\javaLearn\note\.history\郭有根-第十八章作业_20220802143603.md", "Markdown", -526, 0, -111, -637
"f:\data\learn\javaLearn\note\.history\郭有根-第十八章作业_20220805173030.md", "Markdown", -526, 0, -111, -637
"f:\data\learn\javaLearn\note\.history\郭有根-第十八章作业_20220805185804.md", "Markdown", -526, 0, -111, -637
"f:\data\learn\javaLearn\note\.history\郭有根-第十八章作业_20220805185924.md", "Markdown", -526, 0, -111, -637
"f:\data\learn\javaLearn\note\.history\郭有根-第十八章作业_20220805190227.md", "Markdown", -526, 0, -111, -637
"f:\data\learn\javaLearn\note\.history\郭有根-第十八章作业_20220805192642.md", "Markdown", -526, 0, -111, -637
"f:\data\learn\javaLearn\note\.history\郭有根-第十八章作业_20220805192715.md", "Markdown", -526, 0, -111, -637
"f:\data\learn\javaLearn\note\.history\郭有根-第十八章作业_20220805192853.md", "Markdown", -530, 0, -109, -639
"f:\data\learn\javaLearn\note\.history\郭有根-第十八章作业_20220807011136.md", "Markdown", -530, 0, -109, -639
"f:\data\learn\javaLearn\note\.history\郭有根-第十六章作业_20220729090945.md", "Markdown", 0, 0, -1, -1
"f:\data\learn\javaLearn\note\.history\郭有根-第十六章作业_20220729090946.md", "Markdown", -6, 0, -1, -7
"f:\data\learn\javaLearn\note\.history\郭有根-第十六章作业_20220729091050.md", "Markdown", -10, 0, -5, -15
"f:\data\learn\javaLearn\note\.history\郭有根-第十六章作业_20220729091116.md", "Markdown", -12, 0, -5, -17
"f:\data\learn\javaLearn\note\.history\郭有根-第十六章作业_20220729091132.md", "Markdown", -13, 0, -6, -19
"f:\data\learn\javaLearn\note\.history\郭有根-第十六章作业_20220729091138.md", "Markdown", -13, 0, -6, -19
"f:\data\learn\javaLearn\note\.history\郭有根-第十六章作业_20220729091220.md", "Markdown", -17, 0, -10, -27
"f:\data\learn\javaLearn\note\.history\郭有根-第十六章作业_20220729091228.md", "Markdown", -17, 0, -10, -27
"f:\data\learn\javaLearn\note\.history\郭有根-第十六章作业_20220729091236.md", "Markdown", -17, 0, -10, -27
"f:\data\learn\javaLearn\note\.history\郭有根-第十六章作业_20220729091312.md", "Markdown", -17, 0, -10, -27
"f:\data\learn\javaLearn\note\.history\郭有根-第十六章作业_20220729091358.md", "Markdown", -23, 0, -15, -38
"f:\data\learn\javaLearn\note\.history\郭有根-第十六章作业_20220729091421.md", "Markdown", -25, 0, -16, -41
"f:\data\learn\javaLearn\note\.history\郭有根-第十六章作业_20220729091445.md", "Markdown", -56, 0, -15, -71
"f:\data\learn\javaLearn\note\.history\郭有根-第十六章作业_20220729091521.md", "Markdown", -66, 0, -16, -82
"f:\data\learn\javaLearn\note\.history\郭有根-第十六章作业_20220729091553.md", "Markdown", -69, 0, -18, -87
"f:\data\learn\javaLearn\note\.history\郭有根-第十六章作业_20220729091725.md", "Markdown", -81, 0, -20, -101
"f:\data\learn\javaLearn\note\.history\郭有根-第十六章作业_20220729091754.md", "Markdown", -83, 0, -20, -103
"f:\data\learn\javaLearn\note\.history\郭有根-第十六章作业_20220729091812.md", "Markdown", -84, 0, -22, -106
"f:\data\learn\javaLearn\note\.history\郭有根-第十六章作业_20220729092328.md", "Markdown", -94, 0, -23, -117
"f:\data\learn\javaLearn\note\.history\郭有根-第十六章作业_20220729092418.md", "Markdown", -97, 0, -25, -122
"f:\data\learn\javaLearn\note\.history\郭有根-第十六章作业_20220729092509.md", "Markdown", -103, 0, -29, -132
"f:\data\learn\javaLearn\note\.history\郭有根-第十六章作业_20220729092717.md", "Markdown", -124, 0, -30, -154
"f:\data\learn\javaLearn\note\.history\郭有根-第十六章作业_20220729092758.md", "Markdown", -125, 0, -33, -158
"f:\data\learn\javaLearn\note\.history\郭有根-第十六章作业_20220729093254.md", "Markdown", -137, 0, -33, -170
"f:\data\learn\javaLearn\note\.history\郭有根-第十六章作业_20220730005743.md", "Markdown", -137, 0, -33, -170
"f:\data\learn\javaLearn\note\.history\郭有根-第十六章作业_20220730011636.md", "Markdown", -137, 0, -33, -170
"f:\data\learn\javaLearn\note\.history\郭有根-第十六章作业_20220730165612.md", "Markdown", -137, 0, -33, -170
"f:\data\learn\javaLearn\note\.history\郭有根-第十六章作业_20220801022018.md", "Markdown", -137, 0, -35, -172
"f:\data\learn\javaLearn\note\.history\郭有根-第十六章作业_20220801022314.md", "Markdown", -138, 0, -35, -173
"f:\data\learn\javaLearn\note\.history\郭有根-第十六章作业_20220801022443.md", "Markdown", -138, 0, -35, -173
"f:\data\learn\javaLearn\note\.history\郭有根-第十六章作业_20220801022541.md", "Markdown", -146, 0, -37, -183
"f:\data\learn\javaLearn\note\.history\郭有根-第十六章作业_20220801022605.md", "Markdown", -146, 0, -37, -183
"f:\data\learn\javaLearn\note\.history\郭有根-第十六章作业_20220801022716.md", "Markdown", -153, 0, -39, -192
"f:\data\learn\javaLearn\note\.history\郭有根-第十六章作业_20220801022738.md", "Markdown", -154, 0, -39, -193
"f:\data\learn\javaLearn\note\.history\郭有根-第十六章作业_20220801022901.md", "Markdown", -160, 0, -39, -199
"f:\data\learn\javaLearn\note\.history\郭有根-第十六章作业_20220801023106.md", "Markdown", -163, 0, -44, -207
"f:\data\learn\javaLearn\note\.history\郭有根-第十六章作业_20220801025059.md", "Markdown", -164, 0, -43, -207
"f:\data\learn\javaLearn\note\.history\郭有根-第十六章作业_20220801025239.md", "Markdown", -164, 0, -43, -207
"f:\data\learn\javaLearn\note\.history\郭有根-第十六章作业_20220801025553.md", "Markdown", -165, 0, -46, -211
"f:\data\learn\javaLearn\note\.history\郭有根-第十六章作业_20220801025747.md", "Markdown", -166, 0, -45, -211
"f:\data\learn\javaLearn\note\.history\郭有根-第十六章作业_20220801025909.md", "Markdown", -167, 0, -46, -213
"f:\data\learn\javaLearn\note\.history\郭有根-第十六章作业_20220801025938.md", "Markdown", -167, 0, -48, -215
"f:\data\learn\javaLearn\note\.history\郭有根-第十六章作业_20220801030452.md", "Markdown", -170, 0, -47, -217
"f:\data\learn\javaLearn\note\.history\郭有根-第十六章作业_20220801031146.md", "Markdown", -171, 0, -48, -219
"f:\data\learn\javaLearn\note\.history\郭有根-第十六章作业_20220801031238.md", "Markdown", -171, 0, -50, -221
"f:\data\learn\javaLearn\note\.history\郭有根-第十六章作业_20220801032459.md", "Markdown", -172, 0, -50, -222
"f:\data\learn\javaLearn\note\.history\郭有根-第十六章作业_20220801032618.md", "Markdown", -173, 0, -49, -222
"f:\data\learn\javaLearn\note\.history\郭有根-第十六章作业_20220801032704.md", "Markdown", -175, 0, -49, -224
"f:\data\learn\javaLearn\note\.history\郭有根-第十六章作业_20220801032856.md", "Markdown", -176, 0, -50, -226
"f:\data\learn\javaLearn\note\.history\郭有根-第十六章作业_20220801032940.md", "Markdown", -176, 0, -51, -227
"f:\data\learn\javaLearn\note\.history\郭有根-第十六章作业_20220801033022.md", "Markdown", -175, 0, -50, -225
"f:\data\learn\javaLearn\note\.history\郭有根-第十六章作业_20220801033136.md", "Markdown", -177, 0, -54, -231
"f:\data\learn\javaLearn\note\.history\郭有根-第十六章作业_20220801033230.md", "Markdown", -191, 0, -62, -253
"f:\data\learn\javaLearn\note\.history\郭有根-第十六章作业_20220801033438.md", "Markdown", -381, 0, -82, -463
"f:\data\learn\javaLearn\note\.history\郭有根-第十六章作业_20220801033631.md", "Markdown", -382, 0, -83, -465
"f:\data\learn\javaLearn\note\.history\郭有根-第十六章作业_20220801033746.md", "Markdown", -381, 0, -85, -466
"f:\data\learn\javaLearn\note\.history\郭有根-第十六章作业_20220801034038.md", "Markdown", -382, 0, -85, -467
"f:\data\learn\javaLearn\note\.history\郭有根-第十六章作业_20220801034139.md", "Markdown", -384, 0, -84, -468
"f:\data\learn\javaLearn\note\.history\郭有根-第十六章作业_20220801034318.md", "Markdown", -384, 0, -84, -468
"f:\data\learn\javaLearn\note\.history\郭有根-第十六章作业_20220801034501.md", "Markdown", -443, 0, -92, -535
"f:\data\learn\javaLearn\note\.history\郭有根-第十六章作业_20220801034655.md", "Markdown", -474, 0, -103, -577
"f:\data\learn\javaLearn\note\.history\郭有根-第十六章作业_20220801034915.md", "Markdown", -512, 0, -105, -617
"f:\data\learn\javaLearn\note\.history\郭有根-第十六章作业_20220801035023.md", "Markdown", -512, 0, -105, -617
"f:\data\learn\javaLearn\note\.history\郭有根-第十六章作业_20220801035237.md", "Markdown", -512, 0, -105, -617
"f:\data\learn\javaLearn\note\.history\郭有根-第十六章作业_20220801035257.md", "Markdown", -512, 0, -105, -617
"f:\data\learn\javaLearn\note\.history\郭有根-第十六章作业_20220801035412.md", "Markdown", -512, 0, -105, -617
"f:\data\learn\javaLearn\note\.history\郭有根-第十六章作业_20220801035449.md", "Markdown", -512, 0, -105, -617
"f:\data\learn\javaLearn\note\.history\郭有根-第十六章作业_20220801112630.md", "Markdown", -512, 0, -105, -617
"f:\data\learn\javaLearn\note\.history\郭有根-第十六章作业_20220801112807.md", "Markdown", -512, 0, -105, -617
"f:\data\learn\javaLearn\note\.history\郭有根-第十四章作业_20220726102952.md", "Markdown", 0, 0, -1, -1
"f:\data\learn\javaLearn\note\.history\郭有根-第十四章作业_20220726102954.md", "Markdown", -6, 0, -1, -7
"f:\data\learn\javaLearn\note\.history\郭有根-第十四章作业_20220726103015.md", "Markdown", -10, 0, -3, -13
"f:\data\learn\javaLearn\note\.history\郭有根-第十四章作业_20220726103156.md", "Markdown", -12, 0, -5, -17
"f:\data\learn\javaLearn\note\.history\郭有根-第十四章作业_20220726103211.md", "Markdown", -13, 0, -6, -19
"f:\data\learn\javaLearn\note\.history\郭有根-第十四章作业_20220726103252.md", "Markdown", -15, 0, -8, -23
"f:\data\learn\javaLearn\note\.history\郭有根-第十四章作业_20220726103302.md", "Markdown", -15, 0, -8, -23
"f:\data\learn\javaLearn\note\.history\郭有根-第十四章作业_20220726103321.md", "Markdown", -16, 0, -11, -27
"f:\data\learn\javaLearn\note\.history\郭有根-第十四章作业_20220726103406.md", "Markdown", -30, 0, -11, -41
"f:\data\learn\javaLearn\note\.history\郭有根-第十四章作业_20220726103423.md", "Markdown", -31, 0, -13, -44
"f:\data\learn\javaLearn\note\.history\郭有根-第十四章作业_20220726103549.md", "Markdown", -38, 0, -14, -52
"f:\data\learn\javaLearn\note\.history\郭有根-第十四章作业_20220726103712.md", "Markdown", -38, 0, -15, -53
"f:\data\learn\javaLearn\note\.history\郭有根-第十四章作业_20220726105147.md", "Markdown", -40, 0, -16, -56
"f:\data\learn\javaLearn\note\.history\郭有根-第十四章作业_20220726105216.md", "Markdown", -47, 0, -17, -64
"f:\data\learn\javaLearn\note\.history\郭有根-第十四章作业_20220726105232.md", "Markdown", -49, 0, -19, -68
"f:\data\learn\javaLearn\note\.history\郭有根-第十四章作业_20220726105356.md", "Markdown", -56, 0, -19, -75
"f:\data\learn\javaLearn\note\.history\郭有根-第十四章作业_20220726105407.md", "Markdown", -57, 0, -20, -77
"f:\data\learn\javaLearn\note\.history\郭有根-第十四章作业_20220726105420.md", "Markdown", -58, 0, -21, -79
"f:\data\learn\javaLearn\note\.history\郭有根-第十四章作业_20220726105430.md", "Markdown", -63, 0, -21, -84
"f:\data\learn\javaLearn\note\.history\郭有根-第十四章作业_20220726105505.md", "Markdown", -62, 0, -21, -83
"f:\data\learn\javaLearn\note\.history\郭有根-第十四章作业_20220726105547.md", "Markdown", -73, 0, -22, -95
"f:\data\learn\javaLearn\note\.history\郭有根-第十四章作业_20220727235724.md", "Markdown", -73, 0, -22, -95
"f:\data\learn\javaLearn\note\.history\郭有根-第十四章作业_20220728012201.md", "Markdown", -73, 0, -23, -96
"f:\data\learn\javaLearn\note\.history\郭有根-第十四章作业_20220728012224.md", "Markdown", -74, 0, -25, -99
"f:\data\learn\javaLearn\note\.history\郭有根-第十四章作业_20220728012417.md", "Markdown", -75, 0, -24, -99
"f:\data\learn\javaLearn\note\.history\郭有根-第十四章作业_20220728012446.md", "Markdown", -76, 0, -26, -102
"f:\data\learn\javaLearn\note\.history\郭有根-第十四章作业_20220728012703.md", "Markdown", -78, 0, -26, -104
"f:\data\learn\javaLearn\note\.history\郭有根-第十四章作业_20220728012754.md", "Markdown", -79, 0, -28, -107
"f:\data\learn\javaLearn\note\.history\郭有根-第十四章作业_20220728012858.md", "Markdown", -122, 0, -30, -152
"f:\data\learn\javaLearn\note\.history\郭有根-第十四章作业_20220728012951.md", "Markdown", -122, 0, -32, -154
"f:\data\learn\javaLearn\note\.history\郭有根-第十四章作业_20220728013132.md", "Markdown", -123, 0, -32, -155
"f:\data\learn\javaLearn\note\.history\郭有根-第十四章作业_20220728013223.md", "Markdown", -124, 0, -32, -156
"f:\data\learn\javaLearn\note\.history\郭有根-第十四章作业_20220728013337.md", "Markdown", -125, 0, -31, -156
"f:\data\learn\javaLearn\note\.history\郭有根-第十四章作业_20220728013358.md", "Markdown", -126, 0, -32, -158
"f:\data\learn\javaLearn\note\.history\郭有根-第十四章作业_20220728013430.md", "Markdown", -127, 0, -34, -161
"f:\data\learn\javaLearn\note\.history\郭有根-第十四章作业_20220728013713.md", "Markdown", -178, 0, -40, -218
"f:\data\learn\javaLearn\note\.history\郭有根-第十四章作业_20220728014006.md", "Markdown", -179, 0, -39, -218
"f:\data\learn\javaLearn\note\.history\郭有根-第十四章作业_20220728014010.md", "Markdown", -179, 0, -39, -218
"f:\data\learn\javaLearn\note\.history\郭有根-第十四章作业_20220728014011.md", "Markdown", -179, 0, -39, -218
"f:\data\learn\javaLearn\note\.history\郭有根-第十四章作业_20220728091415.md", "Markdown", -179, 0, -39, -218
"f:\data\learn\javaLearn\note\.history\郭有根-第十章作业_20220722091047.md", "Markdown", 0, 0, -1, -1
"f:\data\learn\javaLearn\note\.history\郭有根-第十章作业_20220722091049.md", "Markdown", -6, 0, -1, -7
"f:\data\learn\javaLearn\note\.history\郭有根-第十章作业_20220722091216.md", "Markdown", -9, 0, -4, -13
"f:\data\learn\javaLearn\note\.history\郭有根-第十章作业_20220722091233.md", "Markdown", -18, 0, -11, -29
"f:\data\learn\javaLearn\note\.history\郭有根-第十章作业_20220722091240.md", "Markdown", -18, 0, -11, -29
"f:\data\learn\javaLearn\note\.history\郭有根-第十章作业_20220722091419.md", "Markdown", -27, 0, -11, -38
"f:\data\learn\javaLearn\note\.history\郭有根-第十章作业_20220722091444.md", "Markdown", -27, 0, -12, -39
"f:\data\learn\javaLearn\note\.history\郭有根-第十章作业_20220722092330.md", "Markdown", -41, 0, -12, -53
"f:\data\learn\javaLearn\note\.history\郭有根-第十章作业_20220722092550.md", "Markdown", -43, 0, -12, -55
"f:\data\learn\javaLearn\note\.history\郭有根-第十章作业_20220722092611.md", "Markdown", -43, 0, -13, -56
"f:\data\learn\javaLearn\note\.history\郭有根-第十章作业_20220722092703.md", "Markdown", -50, 0, -14, -64
"f:\data\learn\javaLearn\note\.history\郭有根-第十章作业_20220722092842.md", "Markdown", -53, 0, -16, -69
"f:\data\learn\javaLearn\note\.history\郭有根-第十章作业_20220722092955.md", "Markdown", -53, 0, -17, -70
"f:\data\learn\javaLearn\note\.history\郭有根-第十章作业_20220722093100.md", "Markdown", -54, 0, -18, -72
"f:\data\learn\javaLearn\note\.history\郭有根-第十章作业_20220722093231.md", "Markdown", -84, 0, -23, -107
"f:\data\learn\javaLearn\note\.history\郭有根-第十章作业_20220722093253.md", "Markdown", -81, 0, -21, -102
"f:\data\learn\javaLearn\note\.history\郭有根-第十章作业_20220722093319.md", "Markdown", -81, 0, -21, -102
"f:\data\learn\javaLearn\note\.history\郭有根-第十章作业_20220722095822.md", "Markdown", -82, 0, -21, -103
"f:\data\learn\javaLearn\note\.history\郭有根-第十章作业_20220722095839.md", "Markdown", -82, 0, -22, -104
"f:\data\learn\javaLearn\note\.history\郭有根-第十章作业_20220722100020.md", "Markdown", -82, 0, -22, -104
"f:\data\learn\javaLearn\note\.history\郭有根-第十章作业_20220722100035.md", "Markdown", -83, 0, -21, -104
"f:\data\learn\javaLearn\note\.history\郭有根-第十章作业_20220722100055.md", "Markdown", -83, 0, -23, -106
"f:\data\learn\javaLearn\note\.history\郭有根-第十章作业_20220722100214.md", "Markdown", -121, 0, -28, -149
"f:\data\learn\javaLearn\note\.history\郭有根-第十章作业_20220722100259.md", "Markdown", -148, 0, -35, -183
"f:\data\learn\javaLearn\note\.history\郭有根-第十章作业_20220722100359.md", "Markdown", -150, 0, -35, -185
"f:\data\learn\javaLearn\note\.history\郭有根-第十章作业_20220722100440.md", "Markdown", -151, 0, -36, -187
"f:\data\learn\javaLearn\note\.history\郭有根-第十章作业_20220722100510.md", "Markdown", -217, 0, -53, -270
"f:\data\learn\javaLearn\note\.history\郭有根-第十章作业_20220722100553.md", "Markdown", -233, 0, -56, -289
"f:\data\learn\javaLearn\note\.history\郭有根-第十章作业_20220722100637.md", "Markdown", -234, 0, -58, -292
"f:\data\learn\javaLearn\note\.history\郭有根-第十章作业_20220722100657.md", "Markdown", -234, 0, -59, -293
"f:\data\learn\javaLearn\note\.history\郭有根-第十章作业_20220722100726.md", "Markdown", -347, 0, -70, -417
"f:\data\learn\javaLearn\note\.history\郭有根-第十章作业_20220722100816.md", "Markdown", -389, 0, -76, -465
"f:\data\learn\javaLearn\note\.history\郭有根-第十章作业_20220722100958.md", "Markdown", -390, 0, -75, -465
"f:\data\learn\javaLearn\note\.history\郭有根-第十章作业_20220722101204.md", "Markdown", -390, 0, -75, -465
"f:\data\learn\javaLearn\note\.history\郭有根-第十章作业_20220723165536.md", "Markdown", -391, 0, -74, -465
"f:\data\learn\javaLearn\note\.history\郭有根-第十章作业_20220723165731.md", "Markdown", -390, 0, -74, -464
"f:\data\learn\javaLearn\note\markdown\郭有根-第十一章作业.md", "Markdown", 228, 0, 47, 275
"f:\data\learn\javaLearn\note\markdown\郭有根-第十三章作业.md", "Markdown", 411, 0, 62, 473
"f:\data\learn\javaLearn\note\markdown\郭有根-第十九次作业.md", "Markdown", 319, 0, 83, 402
"f:\data\learn\javaLearn\note\markdown\郭有根-第十二章作业.md", "Markdown", 256, 0, 35, 291
"f:\data\learn\javaLearn\note\markdown\郭有根-第十五章作业.md", "Markdown", 181, 0, 49, 230
"f:\data\learn\javaLearn\note\markdown\郭有根-第十八章作业.md", "Markdown", 530, 0, 109, 639
"f:\data\learn\javaLearn\note\markdown\郭有根-第十六章作业.md", "Markdown", 512, 0, 105, 617
"f:\data\learn\javaLearn\note\markdown\郭有根-第十四章作业.md", "Markdown", 179, 0, 39, 218
"f:\data\learn\javaLearn\note\markdown\郭有根-第十章作业.md", "Markdown", 390, 0, 74, 464
"Total", "-", -72429, 0, -16004, -88433