"filename", "language", "Markdown", "comment", "blank", "total"
"f:\data\learn\javaLearn\note\markdown\郭有根-第十一章作业.md", "Markdown", 228, 0, 47, 275
"f:\data\learn\javaLearn\note\markdown\郭有根-第十三章作业.md", "Markdown", 411, 0, 62, 473
"f:\data\learn\javaLearn\note\markdown\郭有根-第十九次作业.md", "Markdown", 319, 0, 83, 402
"f:\data\learn\javaLearn\note\markdown\郭有根-第十二章作业.md", "Markdown", 256, 0, 35, 291
"f:\data\learn\javaLearn\note\markdown\郭有根-第十五章作业.md", "Markdown", 181, 0, 49, 230
"f:\data\learn\javaLearn\note\markdown\郭有根-第十八章作业.md", "Markdown", 530, 0, 109, 639
"f:\data\learn\javaLearn\note\markdown\郭有根-第十六章作业.md", "Markdown", 512, 0, 105, 617
"f:\data\learn\javaLearn\note\markdown\郭有根-第十四章作业.md", "Markdown", 179, 0, 39, 218
"f:\data\learn\javaLearn\note\markdown\郭有根-第十章作业.md", "Markdown", 390, 0, 74, 464
"Total", "-", 3006, 0, 603, 3609